GGCGGTCCCGGGTACTCAA -> GCGGTCCCGGGTACTCAAG
CCCCGGGACAGCGCGTAAT -> CCCGGGACAGCGCGTAATA
GACCGACTGGACCGCCATG -> ACCGACTGGACCGCCATGA
GAGCCGAGACGCTTACATG -> AGCCGAGACGCTTACATGA
TACGTGTTTAAGCTTGCCC -> ACGTGTTTAAGCTTGCCCC
AACAGCTCTCGATGGTATT -> ACAGCTCTCGATGGTATTC
TTAGAGATTTCCGCTATTC -> TAGAGATTTCCGCTATTCT,TAGAGATTTCCGCTATTCA,TAGAGATTTCCGCTATTCA,TAGAGATTTCCGCTATTCG
CCAGATAGAAACTACTCTG -> CAGATAGAAACTACTCTGA
GAACCCGGAAAAGCCGTAG -> AACCCGGAAAAGCCGTAGC
GTCCTCAAGTGCCCATTAC -> TCCTCAAGTGCCCATTACA
CAAGCTGAAACTACTCTGA -> AAGCTGAAACTACTCTGAT
GTCGCAATTGTTGGTGTGA -> TCGCAATTGTTGGTGTGAC
TAGGGATTTTATGCCTGTC -> AGGGATTTTATGCCTGTCG
AATCTAACAGAGCATGCTC -> ATCTAACAGAGCATGCTCC
GACTCGCTAACCATTGAAA -> ACTCGCTAACCATTGAAAC
TATACTCAAAGTCGGACTC -> ATACTCAAAGTCGGACTCG
ACGCATCGGCTGGACGCCT -> CGCATCGGCTGGACGCCTA
TAGAGCCTACAATCGGCTC -> AGAGCCTACAATCGGCTCA
TAGGTACTCGCCGTATCAC -> AGGTACTCGCCGTATCACC
GGGAGAAGGCCCACGATCT -> GGAGAAGGCCCACGATCTA
CGTATGTCCATCAGCACCG -> GTATGTCCATCAGCACCGT
CTGCTCGTATCAGTGCGTG -> TGCTCGTATCAGTGCGTGC
CGAAGAAATCTAACAGAGC -> GAAGAAATCTAACAGAGCA
TGGTCGCGATGTGCTTAGT -> GGTCGCGATGTGCTTAGTA
CATCTCTCAGGGAGAAGGC -> ATCTCTCAGGGAGAAGGCC
GTGTTTAAGCTTGCCCCGG -> TGTTTAAGCTTGCCCCGGG
CACGTGTGACCTTACCTCG -> ACGTGTGACCTTACCTCGC
TCGGGTTAGAGATTTCCGC -> CGGGTTAGAGATTTCCGCT
TGGAGAGCCGACGCCGTCG -> GGAGAGCCGACGCCGTCGA
AACCAACCGTTAAAATCGG -> ACCAACCGTTAAAATCGGG
TGATGGTTCGCGACCTCGA -> GATGGTTCGCGACCTCGAT
ATTGCAATGCTCTAGCATA -> TTGCAATGCTCTAGCATAC
AAAACCGAGGCTCTCAGTA -> AAACCGAGGCTCTCAGTAC
CACACCTGATCATTTGCGT -> ACACCTGATCATTTGCGTT
ATACACGTGTGACCTTACC -> TACACGTGTGACCTTACCT
GTCAGCCCGTCCCTTCTGT -> TCAGCCCGTCCCTTCTGTT
ATCTGTGTAACGACCAGAT -> TCTGTGTAACGACCAGATA
CTATTTTGTCAATAAACCA -> TATTTTGTCAATAAACCAA
ATGACGAAATGCTCGAGGG -> TGACGAAATGCTCGAGGGA
GCACCTTCTGCGGAGCACG -> CACCTTCTGCGGAGCACGG
ACGACCAGATAGAAACTAC -> CGACCAGATAGAAACTACT
AGATGGTCGCGATGTGCTT -> GATGGTCGCGATGTGCTTA
CAGCCCGTCCCTTCTGTTA -> AGCCCGTCCCTTCTGTTAG
ACCTCGATTAGAGATTTCC -> CCTCGATTAGAGATTTCCG
AATGTTTGTCTTTTAAATA -> ATGTTTGTCTTTTAAATAG
CTGATGGTTTAAGAGAAGC -> TGATGGTTTAAGAGAAGCG
TATCACTTCTCGACAGAGA -> ATCACTTCTCGACAGAGAT
TCTGCTACGGAACGGGCGC -> CTGCTACGGAACGGGCGCA
GAGACTATCACCGGTGAGT -> AGACTATCACCGGTGAGTT
CGAAATGCTCGAGGGACGG -> GAAATGCTCGAGGGACGGT
TTGGAATCAGAACCGCCTA -> TGGAATCAGAACCGCCTAT
AAAGCCGTAGCGTGCAGGC -> AAGCCGTAGCGTGCAGGCG
AAGGCCTTTAGTCTCACAC -> AGGCCTTTAGTCTCACACC
ATCTAACAGAGCATGCTCC -> TCTAACAGAGCATGCTCCG
AGCCCGTCCCTTCTGTTAG -> GCCCGTCCCTTCTGTTAGA
GGTGTGACTCCGAAGAAAT -> GTGTGACTCCGAAGAAATC
GACCTGCAATCACGCGGCC -> ACCTGCAATCACGCGGCCA
ACCCGGCCGAACACTTCCT -> CCCGGCCGAACACTTCCTG
TACACATGTAGGGTGGACT -> ACACATGTAGGGTGGACTA
GGTAAGCTATTCTACTTTC -> GTAAGCTATTCTACTTTCT
TTACGCACCTTCTGCGGAG -> TACGCACCTTCTGCGGAGC
TGAGTTTAATTAGACCTGC -> GAGTTTAATTAGACCTGCA
AGCGTCCTCAAGTGCCCAT -> GCGTCCTCAAGTGCCCATT
GCTGTTACCGTGGACGGAA -> CTGTTACCGTGGACGGAAT
CACGGCTCGGTGAGTTACG -> ACGGCTCGGTGAGTTACGC
TTAATTGCTGGAGAGCCTC -> TAATTGCTGGAGAGCCTCT
AGTACTAGGTACTCGCCGT -> GTACTAGGTACTCGCCGTA
AGAATACCGCGTAAAGCTT -> GAATACCGCGTAAAGCTTA
AGATTTCCGCTATTCACGG -> GATTTCCGCTATTCACGGC
TCTGATGGTTTAAGAGAAG -> CTGATGGTTTAAGAGAAGC
TCTACTTTCTCAGCTTGGA -> CTACTTTCTCAGCTTGGAC
GTTTAATTAGACCTGCAAT -> TTTAATTAGACCTGCAATC
AGCTTGTCAGGTGATAATC -> GCTTGTCAGGTGATAATCC
TCAAATGTTTGTCTTTTAA -> CAAATGTTTGTCTTTTAAA
CGTGAGCTTGTCAGGTGAT -> GTGAGCTTGTCAGGTGATA
GGCTAGTCAATCTACTCCT -> GCTAGTCAATCTACTCCTT
ACTCGAACATATGAATTGA -> CTCGAACATATGAATTGAA
CTGCTTTCTGCTACGGAAC -> TGCTTTCTGCTACGGAACG
GGACTAGAGGACGCATGCG -> GACTAGAGGACGCATGCGG
AGATATCAAGGCCTTTAGT -> GATATCAAGGCCTTTAGTC
ATGGAAAGTACCCCTGTGA -> TGGAAAGTACCCCTGTGAC
CTCGTACTATTTTGTCAAT -> TCGTACTATTTTGTCAATA
AGAGCCTCTTACCTGATCT -> GAGCCTCTTACCTGATCTA
GGAGAAGGCCCACGATCTA -> GAGAAGGCCCACGATCTAT
TAATTAGACCTGCAATCAC -> AATTAGACCTGCAATCACG
TGGAGAGCCTCTTACCTGA -> GGAGAGCCTCTTACCTGAT
CGCGTAAAGCTTAATTGCT -> GCGTAAAGCTTAATTGCTG
ACCGTTAAAATCGGGAAAG -> CCGTTAAAATCGGGAAAGA
GTTACCGTGGACGGAATGC -> TTACCGTGGACGGAATGCT
TCTGGACTTAGAGATTTCC -> CTGGACTTAGAGATTTCCG
TTGACTAACTACCGCCCTT -> TGACTAACTACCGCCCTTG
TGCCCATTACAGCATGGCA -> GCCCATTACAGCATGGCAG
AGAAGCCATGTCTGGGCTA -> GAAGCCATGTCTGGGCTAG
ATTCTTGACCTTTGGCCCG -> TTCTTGACCTTTGGCCCGT
ATGTCTAGCTTCGCATCTC -> TGTCTAGCTTCGCATCTCT
CTAGAGGACGCATGCGGAT -> TAGAGGACGCATGCGGATT
GTGTCTCGACTCAGGTATC -> TGTCTCGACTCAGGTATCT
CCGGGACAGCGCGTAATAA -> CGGGACAGCGCGTAATAAT
CCGACCGACTGGACCGCCA -> CGACCGACTGGACCGCCAT
GACTGCGGTACTCTCTACG -> ACTGCGGTACTCTCTACGA
TAGCGTATGTCCATCAGCA -> AGCGTATGTCCATCAGCAC
GGACGGTAAGCTATTCTAC -> GACGGTAAGCTATTCTACT
TAGGGAAGGCCCTTCCGCG -> AGGGAAGGCCCTTCCGCGG
GTTCATGCATCAGCATCTG -> TTCATGCATCAGCATCTGT
TCACACCTGAGGTCCTGCT -> CACACCTGAGGTCCTGCTC
CGCGGCTTGGGGAACCCAC -> GCGGCTTGGGGAACCCACC
ACAGAATACCGCGTAAAGC -> CAGAATACCGCGTAAAGCT
GATGTGTCTCGACTCAGGT -> ATGTGTCTCGACTCAGGTA
GATTTCCGCTATTCTGGAT -> ATTTCCGCTATTCTGGATG
ATCACGCGGCCAAGATGAA -> TCACGCGGCCAAGATGAAC
GTCTTCAGGCGCCAATATC -> TCTTCAGGCGCCAATATCC
TACTCTGATGGTTGACCGA -> ACTCTGATGGTTGACCGAT
GATTCTTGACCTTTGGCCC -> ATTCTTGACCTTTGGCCCG
ACCCGGAAAAGCCGTAGCG -> CCCGGAAAAGCCGTAGCGT
CACACCTGAGGTCCTGCTC -> ACACCTGAGGTCCTGCTCG
ATGTGACTCTTTGTCCTTT -> TGTGACTCTTTGTCCTTTA
AAGGTCAGCCCGTCCCTTC -> AGGTCAGCCCGTCCCTTCT
GACTCAGGTATCTGCTCAA -> ACTCAGGTATCTGCTCAAA
TGCTTTCTGCTACGGAACG -> GCTTTCTGCTACGGAACGG
AGTCGTGGGAGTCAAGGCG -> GTCGTGGGAGTCAAGGCGC
GATAATCCCAATCTGTGTC -> ATAATCCCAATCTGTGTCT
CCTTTCGGAAACGCCGACA -> CTTTCGGAAACGCCGACAC
TCTACGTCTACCATGTTCA -> CTACGTCTACCATGTTCAT
CAAGATGAACATTTAAACT -> AAGATGAACATTTAAACTT
TATTCGTCAAATGTCTAGC -> ATTCGTCAAATGTCTAGCT
GTGTACCGTGAGCTTGTCA -> TGTACCGTGAGCTTGTCAG
TTAGTAAAGAGATCTGGAA -> TAGTAAAGAGATCTGGAAC
CCGACACTACACATGTAGG -> CGACACTACACATGTAGGG
CACTACACATGTAGGGTGG -> ACTACACATGTAGGGTGGA
ACTAACTACCGCCCTTGTT -> CTAACTACCGCCCTTGTTC
CCGACCACGCGCGGCTTGG -> CGACCACGCGCGGCTTGGG
AAGCTTAATTGCTGGAGAG -> AGCTTAATTGCTGGAGAGC
AGCCGACGCCGTCGAAACT -> GCCGACGCCGTCGAAACTA
GATACTCTGGAACTAATTC -> ATACTCTGGAACTAATTCT
CTCGAGGTACTGCTTTCTG -> TCGAGGTACTGCTTTCTGC
CTTAGTAAAGAGATCTGGA -> TTAGTAAAGAGATCTGGAA
TCACGGCTCGGTGAGTTAC -> CACGGCTCGGTGAGTTACG
ATCCTAATGAGACCCGGCC -> TCCTAATGAGACCCGGCCG
CATGCGAAAGTATCGCTCA -> ATGCGAAAGTATCGCTCAC
CCAAGATATCAAGGCCTTT -> CAAGATATCAAGGCCTTTA
TACTAGGTACTCGCCGTAT -> ACTAGGTACTCGCCGTATC
ATAGCCGCACACCTGATCA -> TAGCCGCACACCTGATCAT
ACCTTTGGCCCGTGTATAA -> CCTTTGGCCCGTGTATAAC
GAATTGAAAAGTCGTGGGA -> AATTGAAAAGTCGTGGGAG
TAGCATAACCCTCTCTACG -> AGCATAACCCTCTCTACGT
CGAGACGCTTACATGAGGT -> GAGACGCTTACATGAGGTC
GCAGCCAACTTACTCATGT -> CAGCCAACTTACTCATGTG
TCTCAGCTTGGACAAAACC -> CTCAGCTTGGACAAAACCG
GATTAGAGATTTCCGCTAT -> ATTAGAGATTTCCGCTATT
TTCATGCATCAGCATCTGT -> TCATGCATCAGCATCTGTG
CATGATAGCCGCACACCTG -> ATGATAGCCGCACACCTGA
GACCTATTTCTTTACTGTC -> ACCTATTTCTTTACTGTCT
GAAGCACGAGCCGAGACGC -> AAGCACGAGCCGAGACGCT
CCTCGATTAGAGATTTCCG -> CTCGATTAGAGATTTCCGC
ATCAGTGCGTGCCCTTTCG -> TCAGTGCGTGCCCTTTCGG
TCTTTCTGCGTCTGTTCAT -> CTTTCTGCGTCTGTTCATG
AAACTACTCTGATGGTTGA -> AACTACTCTGATGGTTGAC
TGCTCCGACCACGCGCGGC -> GCTCCGACCACGCGCGGCT
CGTGCGTTACCCTGCGCTG -> GTGCGTTACCCTGCGCTGA
GATACAAGCGTCCTCAAGT -> ATACAAGCGTCCTCAAGTG
AGAAATCTAACAGAGCATG -> GAAATCTAACAGAGCATGC
GTAGGCGGTCCCGGGTACT -> TAGGCGGTCCCGGGTACTC
CATTATTGCAATGCTCTAG -> ATTATTGCAATGCTCTAGC
AAAGTCGGACTCGCTAACC -> AAGTCGGACTCGCTAACCA
GTACCGTGAGCTTGTCAGG -> TACCGTGAGCTTGTCAGGT
GTGACTCCGAAGAAATCTA -> TGACTCCGAAGAAATCTAA
GCTTGTCAGGTGATAATCC -> CTTGTCAGGTGATAATCCC
ACATATGAATTGAAAAGTC -> CATATGAATTGAAAAGTCG
GGCTTGGGGAACCCACCGA -> GCTTGGGGAACCCACCGAC
AGCCATGTCTGGGCTAGTC -> GCCATGTCTGGGCTAGTCA
CTCTAGCATACCTATAACT -> TCTAGCATACCTATAACTG
AGACCTGCAATCACGCGGC -> GACCTGCAATCACGCGGCC
AGAGCCGACGCCGTCGAAA -> GAGCCGACGCCGTCGAAAC
TACCTATAACTGCGAGCAA -> ACCTATAACTGCGAGCAAG
CAGAAGCCATGTCTGGGCT -> AGAAGCCATGTCTGGGCTA
GGTCAGCCCGTCCCTTCTG -> GTCAGCCCGTCCCTTCTGT
GAACCCTCCGAGACTATCA -> AACCCTCCGAGACTATCAC
GGATTGTGATAGACGCCAC -> GATTGTGATAGACGCCACG
CGCATTATTGCAATGCTCT -> GCATTATTGCAATGCTCTA
ATTGAAAAGTCGTGGGAGT -> TTGAAAAGTCGTGGGAGTC
CAAATTACTTCGGGCTAGT -> AAATTACTTCGGGCTAGTT
CGAACATATGAATTGAAAA -> GAACATATGAATTGAAAAG
AGTATCACTTCTCGACAGA -> GTATCACTTCTCGACAGAG
GGCCGAACACTTCCTGCGC -> GCCGAACACTTCCTGCGCC
AACCCGGAAAAGCCGTAGC -> ACCCGGAAAAGCCGTAGCG
TTAAATAGGGATTTTATGC -> TAAATAGGGATTTTATGCC
CGTGCAGGCGTACAGAATA -> GTGCAGGCGTACAGAATAC
CCTGTCGTGCGTTACCCTG -> CTGTCGTGCGTTACCCTGC
GAGGTCATGCGAAAGTATC -> AGGTCATGCGAAAGTATCG
CCGAACACTTCCTGCGCCT -> CGAACACTTCCTGCGCCTC
TGACCCGACCGACTGGACC -> GACCCGACCGACTGGACCG
GCAATGCTCTAGCATACCT -> CAATGCTCTAGCATACCTA
ACCGTGCGTCCACAGGATG -> CCGTGCGTCCACAGGATGA
ACCAAGATATCAAGGCCTT -> CCAAGATATCAAGGCCTTT
ACCTTCTGGACTTAGAGAT -> CCTTCTGGACTTAGAGATT
CTGATCATTTGCGTTAGCA -> TGATCATTTGCGTTAGCAT
TTTCCGCTATTCGTCAAAT -> TTCCGCTATTCGTCAAATG
TGTTAAAATGACTGCGGTA -> GTTAAAATGACTGCGGTAC
ACCTGATCTAGCCTGATCA -> CCTGATCTAGCCTGATCAA
TATTTGTTTACAAGATAAA -> ATTTGTTTACAAGATAAAA
GCGTATGTCCATCAGCACC -> CGTATGTCCATCAGCACCG
CTATTCGTCAAATGTCTAG -> TATTCGTCAAATGTCTAGC
CTGCTTAGGGAAGGCCCTT -> TGCTTAGGGAAGGCCCTTC
CATGCATCAGCATCTGTGT -> ATGCATCAGCATCTGTGTA
TGCTCGTATCAGTGCGTGC -> GCTCGTATCAGTGCGTGCC
TACTTATCCTAATGAGACC -> ACTTATCCTAATGAGACCC
TAGCTGTTACCGTGGACGG -> AGCTGTTACCGTGGACGGA
TCATGCATCAGCATCTGTG -> CATGCATCAGCATCTGTGT
CGCATGCGGATTGTGATAG -> GCATGCGGATTGTGATAGA
TGAAACTCGAACATATGAA -> GAAACTCGAACATATGAAT
GTATCAGTGCGTGCCCTTT -> TATCAGTGCGTGCCCTTTC
GGAATGCTAATCAATCAAT -> GAATGCTAATCAATCAATT
TCACTTCTCGACAGAGATG -> CACTTCTCGACAGAGATGG
CACGGCTTCCGTGAAGCAC -> ACGGCTTCCGTGAAGCACG
TGACACGCATCGGCTGGAC -> GACACGCATCGGCTGGACG
GTGGACTATTGGAATCAGA -> TGGACTATTGGAATCAGAA
CTAGTTATACCAAGATATC -> TAGTTATACCAAGATATCA
CAACCGTGTATACTCAAAG -> AACCGTGTATACTCAAAGT
TGGGGAACCCACCGACGAA -> GGGGAACCCACCGACGAAA
CATTTAAACTTTGCAATTG -> ATTTAAACTTTGCAATTGT
ACGCTTACATGAGGTCATG -> CGCTTACATGAGGTCATGC
TACATGAGGTCATGCGAAA -> ACATGAGGTCATGCGAAAG
GACCTTTGGCCCGTGTATA -> ACCTTTGGCCCGTGTATAA
AGGCTCTCAGTACTAGGTA -> GGCTCTCAGTACTAGGTAC
ACTTTGCAATTGTTAATGG -> CTTTGCAATTGTTAATGGA
TGTGACTCTTTGTCCTTTA -> GTGACTCTTTGTCCTTTAG
GGCCAAGATGAACATTTAA -> GCCAAGATGAACATTTAAA
GGTATTCTGCTTAGGGAAG -> GTATTCTGCTTAGGGAAGG
GCGTAATAATGTCGCAATT -> CGTAATAATGTCGCAATTG
TAAAATTGACCCGACCGAC -> AAAATTGACCCGACCGACT
CTTATCCTAATGAGACCCG -> TTATCCTAATGAGACCCGG
GTGAGTTTAATTAGACCTG -> TGAGTTTAATTAGACCTGC
ATTCGTCAAATGTCTAGCT -> TTCGTCAAATGTCTAGCTT
ACATGTAGGGTGGACTATT -> CATGTAGGGTGGACTATTG
GCCTCTTACCTGATCTAGC -> CCTCTTACCTGATCTAGCC
CAACCGTTAAAATCGGGAA -> AACCGTTAAAATCGGGAAA
GCGAAAGTATCGCTCACAT -> CGAAAGTATCGCTCACATG
GGGAAAGAACTAAAGCAGG -> GGAAAGAACTAAAGCAGGC
GATTTCCGCTATTCAATCC -> ATTTCCGCTATTCAATCCG
CGTCTACCATGTTCATGAC -> GTCTACCATGTTCATGACT
TTCACGGCTCGGTGAGTTA -> TCACGGCTCGGTGAGTTAC
AAATCGGGAAAGAACTAAA -> AATCGGGAAAGAACTAAAG
GACAGCGCGTAATAATGTC -> ACAGCGCGTAATAATGTCG
GAGATCTGGAACCTCGTAC -> AGATCTGGAACCTCGTACT
TCGGACTCGCTAACCATTG -> CGGACTCGCTAACCATTGA
AATCTACTCCTTCCCCAAC -> ATCTACTCCTTCCCCAACC
TATGTAGGCGGTCCCGGGT -> ATGTAGGCGGTCCCGGGTA
CCTATAACTGCGAGCAAGG -> CTATAACTGCGAGCAAGGT
TTTAAACACTATTGGAGAG -> TTAAACACTATTGGAGAGC
ACAATCGGCTCACTGACCT -> CAATCGGCTCACTGACCTA
GGTTCGCGACCTCGATTAG -> GTTCGCGACCTCGATTAGA
ACGCCGACACTACACATGT -> CGCCGACACTACACATGTA
ATAATGTCGCAATTGTTGG -> TAATGTCGCAATTGTTGGT
ATGGTATTCTGCTTAGGGA -> TGGTATTCTGCTTAGGGAA
GACACTACACATGTAGGGT -> ACACTACACATGTAGGGTG
CTGGACGCCTATACACGTG -> TGGACGCCTATACACGTGT
TAAACCAACCGTTAAAATC -> AAACCAACCGTTAAAATCG
GCCCATTACAGCATGGCAG -> CCCATTACAGCATGGCAGA
CGGATACTCTGGAACTAAT -> GGATACTCTGGAACTAATT
ATGCTCGAGGGACGGTAAG -> TGCTCGAGGGACGGTAAGC
TAAAGCTTAATTGCTGGAG -> AAAGCTTAATTGCTGGAGA
AGCAAGGTCAGCCCGTCCC -> GCAAGGTCAGCCCGTCCCT
TACCATGTTCATGACTTCA -> ACCATGTTCATGACTTCAC
GGGACGGTAAGCTATTCTA -> GGACGGTAAGCTATTCTAC
ACCCCTGTGACACGCATCG -> CCCCTGTGACACGCATCGG
CAGAATACCGCGTAAAGCT -> AGAATACCGCGTAAAGCTT
AACATTTAAACTTTGCAAT -> ACATTTAAACTTTGCAATT
TCCCGACAACGTCTCGCAA -> CCCGACAACGTCTCGCAAG
CCCAACCGTGTATACTCAA -> CCAACCGTGTATACTCAAA
ACCGACTGGACCGCCATGA -> CCGACTGGACCGCCATGAC
TCTTTACTGTCTGTTAAAA -> CTTTACTGTCTGTTAAAAT
GACTTAGAGATTTCCGCTA -> ACTTAGAGATTTCCGCTAT
TCCGCTATTCTGGATGTGT -> CCGCTATTCTGGATGTGTC
CCGCCCTTGTTCCCGACAA -> CGCCCTTGTTCCCGACAAC
CGCTATTCACGGCTCGGTG -> GCTATTCACGGCTCGGTGA
TCAGTGCGTGCCCTTTCGG -> CAGTGCGTGCCCTTTCGGA
TATTCACGGCTCGGTGAGT -> ATTCACGGCTCGGTGAGTT
CAAGGCCTTTAGTCTCACA -> AAGGCCTTTAGTCTCACAC
ACCAGATAGAAACTACTCT -> CCAGATAGAAACTACTCTG
TTCGGGCTAGTTATACCAA -> TCGGGCTAGTTATACCAAG
CGAGCAAGGTCAGCCCGTC -> GAGCAAGGTCAGCCCGTCC
ATGTCGCAATTGTTGGTGT -> TGTCGCAATTGTTGGTGTG
GTTGGATAGCGTATGTCCA -> TTGGATAGCGTATGTCCAT
GACTTGCTAGGAACCCTCC -> ACTTGCTAGGAACCCTCCG
CTACTCCTTCCCCAACCGT -> TACTCCTTCCCCAACCGTG
GCTCGAGGGACGGTAAGCT -> CTCGAGGGACGGTAAGCTA
CTAGCTTCGCATCTCTCAG -> TAGCTTCGCATCTCTCAGG
GTATCACTTCTCGACAGAG -> TATCACTTCTCGACAGAGA
AGCCGTTTCGTGTACCGTG -> GCCGTTTCGTGTACCGTGA
TCAGTACTAGGTACTCGCC -> CAGTACTAGGTACTCGCCG
CTTACATGAGGTCATGCGA -> TTACATGAGGTCATGCGAA
TACTGCTTTCTGCTACGGA -> ACTGCTTTCTGCTACGGAA
ATGATTGACTAACTACCGC -> TGATTGACTAACTACCGCC
TGCGAAAGTATCGCTCACA -> GCGAAAGTATCGCTCACAT
GACACGCATCGGCTGGACG -> ACACGCATCGGCTGGACGC
TCAAGGCCTTTAGTCTCAC -> CAAGGCCTTTAGTCTCACA
TAAGAGGCGGTTGGATAGC -> AAGAGGCGGTTGGATAGCG
AACACTTCCTGCGCCTCAT -> ACACTTCCTGCGCCTCATG
GTGCGTTACCCTGCGCTGA -> TGCGTTACCCTGCGCTGAC
GTTCATTTATGTAGGCGGT -> TTCATTTATGTAGGCGGTC
TGGACGCCTATACACGTGT -> GGACGCCTATACACGTGTG
ATTTGTTTACAAGATAAAA -> TTTGTTTACAAGATAAAAT
AATTGTTAATGGAAAGTAC -> ATTGTTAATGGAAAGTACC
GCATGGCAGAAGCCATGTC -> CATGGCAGAAGCCATGTCT
GCTCACTGACCTATTTCTT -> CTCACTGACCTATTTCTTT
ACTTCTCGACAGAGATGGT -> CTTCTCGACAGAGATGGTC
AGAACCGCCTATAGCTGTT -> GAACCGCCTATAGCTGTTA
TTCTGCTTAGGGAAGGCCC -> TCTGCTTAGGGAAGGCCCT
CCTATAGCTGTTACCGTGG -> CTATAGCTGTTACCGTGGA
AAGGCCCACGATCTATTGT -> AGGCCCACGATCTATTGTT
TTCTTGACCTTTGGCCCGT -> TCTTGACCTTTGGCCCGTG
CAATCTACTCCTTCCCCAA -> AATCTACTCCTTCCCCAAC
GCGCTGACTTGAGAAGGCT -> CGCTGACTTGAGAAGGCTA
TTTATCTACTTATCCTAAT -> TTATCTACTTATCCTAATG
TCTAGCATACCTATAACTG -> CTAGCATACCTATAACTGC
TGCAATGCTCTAGCATACC -> GCAATGCTCTAGCATACCT
TTGTGATAGACGCCACGAC -> TGTGATAGACGCCACGACT
ATCCGGACTAGAGGACGCA -> TCCGGACTAGAGGACGCAT
AGCAGGCGGGCAACAATTT -> GCAGGCGGGCAACAATTTA
TCGAAACTACTCTGATGGT -> CGAAACTACTCTGATGGTT
CGTCATTTAAACACTATTG -> GTCATTTAAACACTATTGG
CGCGATGTGCTTAGTAAAG -> GCGATGTGCTTAGTAAAGA
TTAGACCTGCAATCACGCG -> TAGACCTGCAATCACGCGG
GGTACTCGCCGTATCACCG -> GTACTCGCCGTATCACCGT
ACTACTCTGATGGTTCGCG -> CTACTCTGATGGTTCGCGA
CCGAGGCTCTCAGTACTAG -> CGAGGCTCTCAGTACTAGG
GACCTCGATTAGAGATTTC -> ACCTCGATTAGAGATTTCC
GCTAGTCAATCTACTCCTT -> CTAGTCAATCTACTCCTTC
TGCGTTAGCATAACCCTCT -> GCGTTAGCATAACCCTCTC
TAGCATACCTATAACTGCG -> AGCATACCTATAACTGCGA
GGTATCTGCTCAAATGTTT -> GTATCTGCTCAAATGTTTG
TCCATCAGCACCGTCATTT -> CCATCAGCACCGTCATTTA
CCGCTATTCACGGCTCGGT -> CGCTATTCACGGCTCGGTG
AATGCTCGAGGGACGGTAA -> ATGCTCGAGGGACGGTAAG
GCTCCGACCACGCGCGGCT -> CTCCGACCACGCGCGGCTT
CTCTCTACGTGTTTAAGCT -> TCTCTACGTGTTTAAGCTT
GCTGACTTGAGAAGGCTAA -> CTGACTTGAGAAGGCTAAG
CTACGTGTTTAAGCTTGCC -> TACGTGTTTAAGCTTGCCC
CTTACCTCGCTCATGTTCG -> TTACCTCGCTCATGTTCGG
TCTACTTATCCTAATGAGA -> CTACTTATCCTAATGAGAC
GGATTTTATGCCTGTCGTG -> GATTTTATGCCTGTCGTGC
TCTGGGCTAGTCAATCTAC -> CTGGGCTAGTCAATCTACT
TTATCCTAATGAGACCCGG -> TATCCTAATGAGACCCGGC
CTGCGCCTCATGATAGCCG -> TGCGCCTCATGATAGCCGC
CTGCTACGGAACGGGCGCA -> TGCTACGGAACGGGCGCAT
CCGTCTTCAGGCGCCAATA -> CGTCTTCAGGCGCCAATAT
ACTAAAGCAGGCGGGCAAC -> CTAAAGCAGGCGGGCAACA
AAAGTACCCCTGTGACACG -> AAGTACCCCTGTGACACGC
GAAAGTACCCCTGTGACAC -> AAAGTACCCCTGTGACACG
AGTTTAATTAGACCTGCAA -> GTTTAATTAGACCTGCAAT
CGACCAGATAGAAACTACT -> GACCAGATAGAAACTACTC
GCTCTAGCATACCTATAAC -> CTCTAGCATACCTATAACT
CGGTTGAACCCGGAAAAGC -> GGTTGAACCCGGAAAAGCC
ACTACTCTGATGGTTTAAG -> CTACTCTGATGGTTTAAGA
GGACTTAGAGATTTCCGCT -> GACTTAGAGATTTCCGCTA
TTACTCATGTGACTCTTTG -> TACTCATGTGACTCTTTGT
AACGCCGACACTACACATG -> ACGCCGACACTACACATGT
TAACAGAGCATGCTCCGAC -> AACAGAGCATGCTCCGACC
AGCTCTCGATGGTATTCTG -> GCTCTCGATGGTATTCTGC
CAGGCGGGCAACAATTTAT -> AGGCGGGCAACAATTTATC
CATGACACAGCCGTTTCGT -> ATGACACAGCCGTTTCGTG
CGCACCTTCTGCGGAGCAC -> GCACCTTCTGCGGAGCACG
ATTGGAATCAGAACCGCCT -> TTGGAATCAGAACCGCCTA
ACTGCGAGCAAGGTCAGCC -> CTGCGAGCAAGGTCAGCCC
ACTGCGGTACTCTCTACGA -> CTGCGGTACTCTCTACGAA
ACACGCATCGGCTGGACGC -> CACGCATCGGCTGGACGCC
TACTCTGATGGTTCGCGAC -> ACTCTGATGGTTCGCGACC
GCGGAGCACGGCTTCCGTG -> CGGAGCACGGCTTCCGTGA
TGTAGGGTGGACTATTGGA -> GTAGGGTGGACTATTGGAA
TTGTCAATAAACCAACCGT -> TGTCAATAAACCAACCGTT
TAATGTCGCAATTGTTGGT -> AATGTCGCAATTGTTGGTG
TCGCATCTCTCAGGGAGAA -> CGCATCTCTCAGGGAGAAG
CTCAGTACTAGGTACTCGC -> TCAGTACTAGGTACTCGCC
GGACCGCCATGACACAGCC -> GACCGCCATGACACAGCCG
CGCTCATGTTCGGAACAAG -> GCTCATGTTCGGAACAAGC
ACGACTCCCCAGATACAAG -> CGACTCCCCAGATACAAGC
GACTGGACCGCCATGACAC -> ACTGGACCGCCATGACACA
CTTAGGGAAGGCCCTTCCG -> TTAGGGAAGGCCCTTCCGC
CAGCTCTCGATGGTATTCT -> AGCTCTCGATGGTATTCTG
GCGGTTGGATAGCGTATGT -> CGGTTGGATAGCGTATGTC
AGACTTGCTAGGAACCCTC -> GACTTGCTAGGAACCCTCC
AGGACGCATGCGGATTGTG -> GGACGCATGCGGATTGTGA
CGAACCAGTAGAATAGACT -> GAACCAGTAGAATAGACTT
CCAATCTGTGTCTACGTCT -> CAATCTGTGTCTACGTCTA
GGAGAGCCGACGCCGTCGA -> GAGAGCCGACGCCGTCGAA
CATGTGACTCTTTGTCCTT -> ATGTGACTCTTTGTCCTTT
AGCGCGTAATAATGTCGCA -> GCGCGTAATAATGTCGCAA
CCTCATGATAGCCGCACAC -> CTCATGATAGCCGCACACC
TTCTCAGCTTGGACAAAAC -> TCTCAGCTTGGACAAAACC
CCGTTAAAATCGGGAAAGA -> CGTTAAAATCGGGAAAGAA
TCCGACCACGCGCGGCTTG -> CCGACCACGCGCGGCTTGG
AGAGCATGCTCCGACCACG -> GAGCATGCTCCGACCACGC
AACGTCTCGCAAGTCCGTC -> ACGTCTCGCAAGTCCGTCT
AAGATATCAAGGCCTTTAG -> AGATATCAAGGCCTTTAGT
CTCACACCTGAGGTCCTGC -> TCACACCTGAGGTCCTGCT
CGTTAGCATAACCCTCTCT -> GTTAGCATAACCCTCTCTA
GATCTATTGTTCATTTATG -> ATCTATTGTTCATTTATGT
ACCTATAACTGCGAGCAAG -> CCTATAACTGCGAGCAAGG
GCTGAAACTACTCTGATGG -> CTGAAACTACTCTGATGGT
TCGGCTCACTGACCTATTT -> CGGCTCACTGACCTATTTC
TTCGCATCTCTCAGGGAGA -> TCGCATCTCTCAGGGAGAA
AGCGTATGTCCATCAGCAC -> GCGTATGTCCATCAGCACC
GACTCTTTGTCCTTTAGCC -> ACTCTTTGTCCTTTAGCCT
CTCTCAGTACTAGGTACTC -> TCTCAGTACTAGGTACTCG
CACTGGCAGTATCACTTCT -> ACTGGCAGTATCACTTCTC
CGTGTTTAAGCTTGCCCCG -> GTGTTTAAGCTTGCCCCGG
CGGCCAAGATGAACATTTA -> GGCCAAGATGAACATTTAA
GAAAGTATCGCTCACATGT -> AAAGTATCGCTCACATGTA
AGCTTCGCATCTCTCAGGG -> GCTTCGCATCTCTCAGGGA
GCTAGGAACCCTCCGAGAC -> CTAGGAACCCTCCGAGACT
GGAGCACGGCTTCCGTGAA -> GAGCACGGCTTCCGTGAAG
GACGCCGTCGAAACTACTC -> ACGCCGTCGAAACTACTCT
TTCCGCTATTCACGGCTCG -> TCCGCTATTCACGGCTCGG
GCAGTATCACTTCTCGACA -> CAGTATCACTTCTCGACAG
TGGTTTAAGAGAAGCGTTA -> GGTTTAAGAGAAGCGTTAG
CCGCCATGACACAGCCGTT -> CGCCATGACACAGCCGTTT
TGTAACGACCAGATAGAAA -> GTAACGACCAGATAGAAAC
GGCTAGTTATACCAAGATA -> GCTAGTTATACCAAGATAT
GGGACAGCGCGTAATAATG -> GGACAGCGCGTAATAATGT
AGCACGAGCCGAGACGCTT -> GCACGAGCCGAGACGCTTA
GAGAAGCGTTAGAGATTTC -> AGAAGCGTTAGAGATTTCC
CATGGCAGAAGCCATGTCT -> ATGGCAGAAGCCATGTCTG
ACACCTGATCATTTGCGTT -> CACCTGATCATTTGCGTTA
AGCCTTTCAAGGCGTCGGA -> GCCTTTCAAGGCGTCGGAT
CTTGTCAGGTGATAATCCC -> TTGTCAGGTGATAATCCCA
AGTATGACGAAATGCTCGA -> GTATGACGAAATGCTCGAG
CCCGGGTACTCAAGTATGA -> CCGGGTACTCAAGTATGAC
ACTACACATGTAGGGTGGA -> CTACACATGTAGGGTGGAC
TTTCCGCTATTCTGGATGT -> TTCCGCTATTCTGGATGTG
GTCATGCGAAAGTATCGCT -> TCATGCGAAAGTATCGCTC
CTAATTCTTTCTGCGTCTG -> TAATTCTTTCTGCGTCTGT
ATAACCCTCTCTACGTGTT -> TAACCCTCTCTACGTGTTT
TGACTAACTACCGCCCTTG -> GACTAACTACCGCCCTTGT
CATTGAAACTCGAACATAT -> ATTGAAACTCGAACATATG
GAAGGCCCACGATCTATTG -> AAGGCCCACGATCTATTGT
CGTCGGATACTCTGGAACT -> GTCGGATACTCTGGAACTA
GAGATTTCCGCTATTCAAT -> AGATTTCCGCTATTCAATC
CGGTGAGTTTAATTAGACC -> GGTGAGTTTAATTAGACCT
CAGCCAACTTACTCATGTG -> AGCCAACTTACTCATGTGA
GACCGCCATGACACAGCCG -> ACCGCCATGACACAGCCGT
CATAACCCTCTCTACGTGT -> ATAACCCTCTCTACGTGTT
TACAGCATGGCAGAAGCCA -> ACAGCATGGCAGAAGCCAT
GGCGCCAATATCCTCGAGG -> GCGCCAATATCCTCGAGGT
CATGTCTGGGCTAGTCAAT -> ATGTCTGGGCTAGTCAATC
TCTCTACGTGTTTAAGCTT -> CTCTACGTGTTTAAGCTTG
GCGGGCAACAATTTATCTA -> CGGGCAACAATTTATCTAC
GCCGTCGAAACTACTCTGA -> CCGTCGAAACTACTCTGAT
AATCGGCTCACTGACCTAT -> ATCGGCTCACTGACCTATT
ACTTACTCATGTGACTCTT -> CTTACTCATGTGACTCTTT
TCACTGACCTATTTCTTTA -> CACTGACCTATTTCTTTAC
CTATTCAATCCGGACTAGA -> TATTCAATCCGGACTAGAG
CAGTACTAGGTACTCGCCG -> AGTACTAGGTACTCGCCGT
CGGAACAAGCTGAAACTAC -> GGAACAAGCTGAAACTACT
GTGCGTCCACAGGATGATT -> TGCGTCCACAGGATGATTG
TCTGATGGTTACCTTCTGG -> CTGATGGTTACCTTCTGGA
CGTCCACAGGATGATTGAC -> GTCCACAGGATGATTGACT
ACAATTTATCTACTTATCC -> CAATTTATCTACTTATCCT
GAGAGCCTCTTACCTGATC -> AGAGCCTCTTACCTGATCT
GAACACTTCCTGCGCCTCA -> AACACTTCCTGCGCCTCAT
ACGCCACGACTCCCCAGAT -> CGCCACGACTCCCCAGATA
AGCATAACCCTCTCTACGT -> GCATAACCCTCTCTACGTG
CCGCTATTCAATCCGGACT -> CGCTATTCAATCCGGACTA
AATGAGACCCGGCCGAACA -> ATGAGACCCGGCCGAACAC
GATAGAAACTACTCTGATG -> ATAGAAACTACTCTGATGG
AAACTACTCTGATGGTTCG -> AACTACTCTGATGGTTCGC
TCACCGTGCGTCCACAGGA -> CACCGTGCGTCCACAGGAT
TACAGAATACCGCGTAAAG -> ACAGAATACCGCGTAAAGC
CGACTCCCCAGATACAAGC -> GACTCCCCAGATACAAGCG
TGTACCGTGAGCTTGTCAG -> GTACCGTGAGCTTGTCAGG
GTCGGACTCGCTAACCATT -> TCGGACTCGCTAACCATTG
CCGTATCACCGTGCGTCCA -> CGTATCACCGTGCGTCCAC
TTGTTGGTGTGACTCCGAA -> TGTTGGTGTGACTCCGAAG
TCTACCATGTTCATGACTT -> CTACCATGTTCATGACTTC
AACCGCCTATAGCTGTTAC -> ACCGCCTATAGCTGTTACC
TGCTGGAGAGCCTCTTACC -> GCTGGAGAGCCTCTTACCT
GCTAACCATTGAAACTCGA -> CTAACCATTGAAACTCGAA
ACATTATGTCACTGGCAGT -> CATTATGTCACTGGCAGTA
ACCGAGGCTCTCAGTACTA -> CCGAGGCTCTCAGTACTAG
TTTAAATAGGGATTTTATG -> TTAAATAGGGATTTTATGC
GTTAAAATCGGGAAAGAAC -> TTAAAATCGGGAAAGAACT
TTCGGAACAAGCTGAAACT -> TCGGAACAAGCTGAAACTA
ATGTGTCTCGACTCAGGTA -> TGTGTCTCGACTCAGGTAT
CCGTGGACGGAATGCTAAT -> CGTGGACGGAATGCTAATC
ATCACCGTGCGTCCACAGG -> TCACCGTGCGTCCACAGGA
AGCCTGATCAAATTACTTC -> GCCTGATCAAATTACTTCG
GTAAGAGGCGGTTGGATAG -> TAAGAGGCGGTTGGATAGC
GCAGGCGGGCAACAATTTA -> CAGGCGGGCAACAATTTAT
TTTCCGCTATTCAATCCGG -> TTCCGCTATTCAATCCGGA
ATGTAGGCGGTCCCGGGTA -> TGTAGGCGGTCCCGGGTAC
GCCTCATGATAGCCGCACA -> CCTCATGATAGCCGCACAC
TCCCTTCTGTTAGAGCCTA -> CCCTTCTGTTAGAGCCTAC
TTGGACAAAACCGAGGCTC -> TGGACAAAACCGAGGCTCT
TAAGCTATTCTACTTTCTC -> AAGCTATTCTACTTTCTCA
CCATCAGCACCGTCATTTA -> CATCAGCACCGTCATTTAA
GGTCCTGCTCGTATCAGTG -> GTCCTGCTCGTATCAGTGC
TGTGCTTAGTAAAGAGATC -> GTGCTTAGTAAAGAGATCT
ACTCTGGAACTAATTCTTT -> CTCTGGAACTAATTCTTTC
GAATACCGCGTAAAGCTTA -> AATACCGCGTAAAGCTTAA
ACCCGACCGACTGGACCGC -> CCCGACCGACTGGACCGCC
TTCAAGGCGTCGGATACTC -> TCAAGGCGTCGGATACTCT
TGAACCCGGAAAAGCCGTA -> GAACCCGGAAAAGCCGTAG
CAGATACAAGCGTCCTCAA -> AGATACAAGCGTCCTCAAG
ACTGTCTGTTAAAATGACT -> CTGTCTGTTAAAATGACTG
CTCTGGAACTAATTCTTTC -> TCTGGAACTAATTCTTTCT
ACTAATTCTTTCTGCGTCT -> CTAATTCTTTCTGCGTCTG
GGTTAGAGATTTCCGCTAT -> GTTAGAGATTTCCGCTATT
ATCTCTCAGGGAGAAGGCC -> TCTCTCAGGGAGAAGGCCC
GAACATATGAATTGAAAAG -> AACATATGAATTGAAAAGT
GTGTAACGACCAGATAGAA -> TGTAACGACCAGATAGAAA
TATCACCGTGCGTCCACAG -> ATCACCGTGCGTCCACAGG
GCTATTCTGGATGTGTCTC -> CTATTCTGGATGTGTCTCG
TCACAGAGTGACATTATGT -> CACAGAGTGACATTATGTC
CTCCTTCCCCAACCGTGTA -> TCCTTCCCCAACCGTGTAT
CCTATTTCTTTACTGTCTG -> CTATTTCTTTACTGTCTGT
TGAAAAGTCGTGGGAGTCA -> GAAAAGTCGTGGGAGTCAA
AATTACTTCGGGCTAGTTA -> ATTACTTCGGGCTAGTTAT
GTCCTTTAGCCTTTCAAGG -> TCCTTTAGCCTTTCAAGGC
ATCTACTTATCCTAATGAG -> TCTACTTATCCTAATGAGA
CGGTGAGTTACGCACCTTC -> GGTGAGTTACGCACCTTCT
TGACTTCACAGAGTGACAT -> GACTTCACAGAGTGACATT
GAAACTCGAACATATGAAT -> AAACTCGAACATATGAATT
TTTATGCCTGTCGTGCGTT -> TTATGCCTGTCGTGCGTTA
CATACCTATAACTGCGAGC -> ATACCTATAACTGCGAGCA
GCATTATTGCAATGCTCTA -> CATTATTGCAATGCTCTAG
CGGTTGGATAGCGTATGTC -> GGTTGGATAGCGTATGTCC
CCGTCGAAACTACTCTGAT -> CGTCGAAACTACTCTGATG
AGCTTGGACAAAACCGAGG -> GCTTGGACAAAACCGAGGC
TACTCTGGAACTAATTCTT -> ACTCTGGAACTAATTCTTT
TTGCTGGAGAGCCTCTTAC -> TGCTGGAGAGCCTCTTACC
GTACTCAAGTATGACGAAA -> TACTCAAGTATGACGAAAT
TTCAATCCGGACTAGAGGA -> TCAATCCGGACTAGAGGAC
AATTGTTGGTGTGACTCCG -> ATTGTTGGTGTGACTCCGA
CTGCAATCACGCGGCCAAG -> TGCAATCACGCGGCCAAGA
CTTAGAGATTTCCGCTATT -> TTAGAGATTTCCGCTATTC
CTTGGGGAACCCACCGACG -> TTGGGGAACCCACCGACGA
CAATATCCTCGAGGTACTG -> AATATCCTCGAGGTACTGC
ATGACACAGCCGTTTCGTG -> TGACACAGCCGTTTCGTGT
GCGTCGGATACTCTGGAAC -> CGTCGGATACTCTGGAACT
CGCCTCATGATAGCCGCAC -> GCCTCATGATAGCCGCACA
GTTAATGGAAAGTACCCCT -> TTAATGGAAAGTACCCCTG
AGAGTGACATTATGTCACT -> GAGTGACATTATGTCACTG
GTTAGAGATTTCCGCTATT -> TTAGAGATTTCCGCTATTC,TTAGAGATTTCCGCTATTC
TGTGTCTCGACTCAGGTAT -> GTGTCTCGACTCAGGTATC
CGTTAGAGATTTCCGCTAT -> GTTAGAGATTTCCGCTATT
TATTCTGGATGTGTCTCGA -> ATTCTGGATGTGTCTCGAC
AGAGAAGCGTTAGAGATTT -> GAGAAGCGTTAGAGATTTC
TGGACTATTGGAATCAGAA -> GGACTATTGGAATCAGAAC
GCTGGAGAGCCTCTTACCT -> CTGGAGAGCCTCTTACCTG
ACTACCGCCCTTGTTCCCG -> CTACCGCCCTTGTTCCCGA
GAGATGGTCGCGATGTGCT -> AGATGGTCGCGATGTGCTT
TACAAGATAAAATTGACCC -> ACAAGATAAAATTGACCCG
GTCAAATGTCTAGCTTCGC -> TCAAATGTCTAGCTTCGCA
AATGTCGCAATTGTTGGTG -> ATGTCGCAATTGTTGGTGT
TAATCAATCAATTATTTGT -> AATCAATCAATTATTTGTT
GTCTGTTCATGCATCAGCA -> TCTGTTCATGCATCAGCAT
GTTGAACCCGGAAAAGCCG -> TTGAACCCGGAAAAGCCGT
GTTGACCGATCGGGTTAGA -> TTGACCGATCGGGTTAGAG
ATGAGACCCGGCCGAACAC -> TGAGACCCGGCCGAACACT
CGCCATGACACAGCCGTTT -> GCCATGACACAGCCGTTTC
GGCGGTTGGATAGCGTATG -> GCGGTTGGATAGCGTATGT
AGTACCCCTGTGACACGCA -> GTACCCCTGTGACACGCAT
TCTGCTTAGGGAAGGCCCT -> CTGCTTAGGGAAGGCCCTT
TACCCTGCGCTGACTTGAG -> ACCCTGCGCTGACTTGAGA
GCGTCCACAGGATGATTGA -> CGTCCACAGGATGATTGAC
GCCTGATCAAATTACTTCG -> CCTGATCAAATTACTTCGG
GCCGAACACTTCCTGCGCC -> CCGAACACTTCCTGCGCCT
AGGGAAGGCCCTTCCGCGG -> GGGAAGGCCCTTCCGCGGT
ATTCTGGATGTGTCTCGAC -> TTCTGGATGTGTCTCGACT
GTGATAGACGCCACGACTC -> TGATAGACGCCACGACTCC
ATGACTTCACAGAGTGACA -> TGACTTCACAGAGTGACAT
TGTTGGTGTGACTCCGAAG -> GTTGGTGTGACTCCGAAGA
CAGCTTGGACAAAACCGAG -> AGCTTGGACAAAACCGAGG
GTATCGCTCACATGTAAGA -> TATCGCTCACATGTAAGAG
GCTAGTTATACCAAGATAT -> CTAGTTATACCAAGATATC
CAAAACCGAGGCTCTCAGT -> AAAACCGAGGCTCTCAGTA
CTCTTTGTCCTTTAGCCTT -> TCTTTGTCCTTTAGCCTTT
ATGTTCGGAACAAGCTGAA -> TGTTCGGAACAAGCTGAAA
AGATGAACATTTAAACTTT -> GATGAACATTTAAACTTTG
ATGTAAGAGGCGGTTGGAT -> TGTAAGAGGCGGTTGGATA
GAAACGCCGACACTACACA -> AAACGCCGACACTACACAT
GTATGACGAAATGCTCGAG -> TATGACGAAATGCTCGAGG
CCACAGGATGATTGACTAA -> CACAGGATGATTGACTAAC
AACTTACTCATGTGACTCT -> ACTTACTCATGTGACTCTT
CTGGACCGCCATGACACAG -> TGGACCGCCATGACACAGC
TACCGTGAGCTTGTCAGGT -> ACCGTGAGCTTGTCAGGTG
CTTCCGTGAAGCACGAGCC -> TTCCGTGAAGCACGAGCCG
CAGAGTGACATTATGTCAC -> AGAGTGACATTATGTCACT
GCTCTCAGTACTAGGTACT -> CTCTCAGTACTAGGTACTC
CGGAAACGCCGACACTACA -> GGAAACGCCGACACTACAC
AGCACCGTCATTTAAACAC -> GCACCGTCATTTAAACACT
GCAATCACGCGGCCAAGAT -> CAATCACGCGGCCAAGATG
CGCATCTCTCAGGGAGAAG -> GCATCTCTCAGGGAGAAGG
GGATGTGTCTCGACTCAGG -> GATGTGTCTCGACTCAGGT
CGCATCGGCTGGACGCCTA -> GCATCGGCTGGACGCCTAT
GCATGCGGATTGTGATAGA -> CATGCGGATTGTGATAGAC
ATGCCTGTCGTGCGTTACC -> TGCCTGTCGTGCGTTACCC
TCTGTGTAACGACCAGATA -> CTGTGTAACGACCAGATAG
AGAAGGCTAAGGATTCTTG -> GAAGGCTAAGGATTCTTGA
AGAGATCTGGAACCTCGTA -> GAGATCTGGAACCTCGTAC
CTAAGGATTCTTGACCTTT -> TAAGGATTCTTGACCTTTG
CTCAGCTTGGACAAAACCG -> TCAGCTTGGACAAAACCGA
GCCTATACACGTGTGACCT -> CCTATACACGTGTGACCTT
ACGAAATGCTCGAGGGACG -> CGAAATGCTCGAGGGACGG
TAATAATGTCGCAATTGTT -> AATAATGTCGCAATTGTTG
AACGACCAGATAGAAACTA -> ACGACCAGATAGAAACTAC
TGTTCATGCATCAGCATCT -> GTTCATGCATCAGCATCTG
GCGTTAGAGATTTCCGCTA -> CGTTAGAGATTTCCGCTAT
GAGCACGGCTTCCGTGAAG -> AGCACGGCTTCCGTGAAGC
GCATCTCTCAGGGAGAAGG -> CATCTCTCAGGGAGAAGGC
CTACCATGTTCATGACTTC -> TACCATGTTCATGACTTCA
AAACTCGAACATATGAATT -> AACTCGAACATATGAATTG
CCTCAAGTGCCCATTACAG -> CTCAAGTGCCCATTACAGC
CAATGCTCTAGCATACCTA -> AATGCTCTAGCATACCTAT
CCCACGATCTATTGTTCAT -> CCACGATCTATTGTTCATT
TTCTGGATGTGTCTCGACT -> TCTGGATGTGTCTCGACTC
GTGAAGCACGAGCCGAGAC -> TGAAGCACGAGCCGAGACG
TTGTCCTTTAGCCTTTCAA -> TGTCCTTTAGCCTTTCAAG
AAATTACTTCGGGCTAGTT -> AATTACTTCGGGCTAGTTA
CTAGGAACCCTCCGAGACT -> TAGGAACCCTCCGAGACTA
ATTTTATGCCTGTCGTGCG -> TTTTATGCCTGTCGTGCGT
TCGCGATGTGCTTAGTAAA -> CGCGATGTGCTTAGTAAAG
AGTCAAGGCGCAGCCAACT -> GTCAAGGCGCAGCCAACTT
GACTAACTACCGCCCTTGT -> ACTAACTACCGCCCTTGTT
TCTGTTCATGCATCAGCAT -> CTGTTCATGCATCAGCATC
CGACAACGTCTCGCAAGTC -> GACAACGTCTCGCAAGTCC
GACTTGAGAAGGCTAAGGA -> ACTTGAGAAGGCTAAGGAT
CTACTCTGATGGTTGACCG -> TACTCTGATGGTTGACCGA
CGAGGGACGGTAAGCTATT -> GAGGGACGGTAAGCTATTC
GGTGAGTTACGCACCTTCT -> GTGAGTTACGCACCTTCTG
AGTAAAGAGATCTGGAACC -> GTAAAGAGATCTGGAACCT
GATCGGGTTAGAGATTTCC -> ATCGGGTTAGAGATTTCCG
TATAACTGCGAGCAAGGTC -> ATAACTGCGAGCAAGGTCA
TTCTGGACTTAGAGATTTC -> TCTGGACTTAGAGATTTCC
CTCGCAAGTCCGTCTTCAG -> TCGCAAGTCCGTCTTCAGG
CCCGTGTATAACAGCTCTC -> CCGTGTATAACAGCTCTCG
GGAATCAGAACCGCCTATA -> GAATCAGAACCGCCTATAG
AACTACTCTGATGGTTTAA -> ACTACTCTGATGGTTTAAG
AGATAGAAACTACTCTGAT -> GATAGAAACTACTCTGATG
TGTCTAGCTTCGCATCTCT -> GTCTAGCTTCGCATCTCTC
GTTCGCGACCTCGATTAGA -> TTCGCGACCTCGATTAGAG
TTACCTCGCTCATGTTCGG -> TACCTCGCTCATGTTCGGA
GCATCTGTGTAACGACCAG -> CATCTGTGTAACGACCAGA
CTAACCATTGAAACTCGAA -> TAACCATTGAAACTCGAAC
GGAAAAGCCGTAGCGTGCA -> GAAAAGCCGTAGCGTGCAG
AGCTTAATTGCTGGAGAGC -> GCTTAATTGCTGGAGAGCC
TAGAGATTTCCGCTATTCA -> AGAGATTTCCGCTATTCAC,AGAGATTTCCGCTATTCAA
CGGGTTAGAGATTTCCGCT -> GGGTTAGAGATTTCCGCTA
GACGGTAAGCTATTCTACT -> ACGGTAAGCTATTCTACTT
TACTATTTTGTCAATAAAC -> ACTATTTTGTCAATAAACC
GAAATGCTCGAGGGACGGT -> AAATGCTCGAGGGACGGTA
CCGCGGTTGAACCCGGAAA -> CGCGGTTGAACCCGGAAAA
GATCTGGAACCTCGTACTA -> ATCTGGAACCTCGTACTAT
TGATGGTTGACCGATCGGG -> GATGGTTGACCGATCGGGT
GATTTTATGCCTGTCGTGC -> ATTTTATGCCTGTCGTGCG
GAAGAAATCTAACAGAGCA -> AAGAAATCTAACAGAGCAT
TGATCATTTGCGTTAGCAT -> GATCATTTGCGTTAGCATA
AACTACTCTGATGGTTCGC -> ACTACTCTGATGGTTCGCG
TCTCTCAGGGAGAAGGCCC -> CTCTCAGGGAGAAGGCCCA
CTGTGTCTACGTCTACCAT -> TGTGTCTACGTCTACCATG
GGAAAGTACCCCTGTGACA -> GAAAGTACCCCTGTGACAC
CGTTTCGTGTACCGTGAGC -> GTTTCGTGTACCGTGAGCT
GTGTCTACGTCTACCATGT -> TGTCTACGTCTACCATGTT
CATGTAAGAGGCGGTTGGA -> ATGTAAGAGGCGGTTGGAT
TGTCTGTTAAAATGACTGC -> GTCTGTTAAAATGACTGCG
TATCCTCGAGGTACTGCTT -> ATCCTCGAGGTACTGCTTT
CGTTAAAATCGGGAAAGAA -> GTTAAAATCGGGAAAGAAC
CAAGTGCCCATTACAGCAT -> AAGTGCCCATTACAGCATG
GGCGGGCAACAATTTATCT -> GCGGGCAACAATTTATCTA
GAAGGCTAAGGATTCTTGA -> AAGGCTAAGGATTCTTGAC
TGGTTACCTTCTGGACTTA -> GGTTACCTTCTGGACTTAG
CACGAGCCGAGACGCTTAC -> ACGAGCCGAGACGCTTACA
AGCTATTCTACTTTCTCAG -> GCTATTCTACTTTCTCAGC
TCAGCACCGTCATTTAAAC -> CAGCACCGTCATTTAAACA
TCACTGGCAGTATCACTTC -> CACTGGCAGTATCACTTCT
TCATGATAGCCGCACACCT -> CATGATAGCCGCACACCTG
GTCTCGACTCAGGTATCTG -> TCTCGACTCAGGTATCTGC
ATGTTTGTCTTTTAAATAG -> TGTTTGTCTTTTAAATAGG
GCTCGTATCAGTGCGTGCC -> CTCGTATCAGTGCGTGCCC
GCACGGCTTCCGTGAAGCA -> CACGGCTTCCGTGAAGCAC
TCAAAGTCGGACTCGCTAA -> CAAAGTCGGACTCGCTAAC
ATATGAATTGAAAAGTCGT -> TATGAATTGAAAAGTCGTG
CTCGCTCATGTTCGGAACA -> TCGCTCATGTTCGGAACAA
CCTTTCAAGGCGTCGGATA -> CTTTCAAGGCGTCGGATAC
GTCCCTTCTGTTAGAGCCT -> TCCCTTCTGTTAGAGCCTA
TTCCGCTATTCAATCCGGA -> TCCGCTATTCAATCCGGAC
TTCTGCGTCTGTTCATGCA -> TCTGCGTCTGTTCATGCAT
TATCAAGGCCTTTAGTCTC -> ATCAAGGCCTTTAGTCTCA
TCGCAATTGTTGGTGTGAC -> CGCAATTGTTGGTGTGACT
GCTTCGCATCTCTCAGGGA -> CTTCGCATCTCTCAGGGAG
AGAAGGCCCACGATCTATT -> GAAGGCCCACGATCTATTG
GTATACTCAAAGTCGGACT -> TATACTCAAAGTCGGACTC
CCCTTGTTCCCGACAACGT -> CCTTGTTCCCGACAACGTC
ATCAGCATCTGTGTAACGA -> TCAGCATCTGTGTAACGAC
TCCGGACTAGAGGACGCAT -> CCGGACTAGAGGACGCATG
TCTCACACCTGAGGTCCTG -> CTCACACCTGAGGTCCTGC
AAGATGAACATTTAAACTT -> AGATGAACATTTAAACTTT
TGCTCAAATGTTTGTCTTT -> GCTCAAATGTTTGTCTTTT
TATTGGAATCAGAACCGCC -> ATTGGAATCAGAACCGCCT
GTATTCTGCTTAGGGAAGG -> TATTCTGCTTAGGGAAGGC
ATTGTTAATGGAAAGTACC -> TTGTTAATGGAAAGTACCC
GTCTCGCAAGTCCGTCTTC -> TCTCGCAAGTCCGTCTTCA
GAGTTACGCACCTTCTGCG -> AGTTACGCACCTTCTGCGG
TGGAACTAATTCTTTCTGC -> GGAACTAATTCTTTCTGCG
TAGAATAGACTTGCTAGGA -> AGAATAGACTTGCTAGGAA
ACTTAGAGATTTCCGCTAT -> CTTAGAGATTTCCGCTATT
CTTCGGGCTAGTTATACCA -> TTCGGGCTAGTTATACCAA
AGAAACTACTCTGATGGTT -> GAAACTACTCTGATGGTTA
ACAACGTCTCGCAAGTCCG -> CAACGTCTCGCAAGTCCGT
GCGTTAGCATAACCCTCTC -> CGTTAGCATAACCCTCTCT
CCCAGATACAAGCGTCCTC -> CCAGATACAAGCGTCCTCA
TTTGTCCTTTAGCCTTTCA -> TTGTCCTTTAGCCTTTCAA
TGAGGTCATGCGAAAGTAT -> GAGGTCATGCGAAAGTATC
ACTCCTTCCCCAACCGTGT -> CTCCTTCCCCAACCGTGTA
GAGGGACGGTAAGCTATTC -> AGGGACGGTAAGCTATTCT
AGGTCAGCCCGTCCCTTCT -> GGTCAGCCCGTCCCTTCTG
TGCGGAGCACGGCTTCCGT -> GCGGAGCACGGCTTCCGTG
ACGGGCGCATTATTGCAAT -> CGGGCGCATTATTGCAATG
AATCTGTGTCTACGTCTAC -> ATCTGTGTCTACGTCTACC
ACTCGCTAACCATTGAAAC -> CTCGCTAACCATTGAAACT
GTTCATGACTTCACAGAGT -> TTCATGACTTCACAGAGTG
CATATGAATTGAAAAGTCG -> ATATGAATTGAAAAGTCGT
ATGCGAAAGTATCGCTCAC -> TGCGAAAGTATCGCTCACA
AAGAGATCTGGAACCTCGT -> AGAGATCTGGAACCTCGTA
CCGTCCCTTCTGTTAGAGC -> CGTCCCTTCTGTTAGAGCC
CGATTAGAGATTTCCGCTA -> GATTAGAGATTTCCGCTAT
CGACACTACACATGTAGGG -> GACACTACACATGTAGGGT
ACACTTCCTGCGCCTCATG -> CACTTCCTGCGCCTCATGA
TTCTGTTAGAGCCTACAAT -> TCTGTTAGAGCCTACAATC
TGACGAAATGCTCGAGGGA -> GACGAAATGCTCGAGGGAC
GCTTGCCCCGGGACAGCGC -> CTTGCCCCGGGACAGCGCG
CCAATATCCTCGAGGTACT -> CAATATCCTCGAGGTACTG
TGCAATTGTTAATGGAAAG -> GCAATTGTTAATGGAAAGT
GCCGCACACCTGATCATTT -> CCGCACACCTGATCATTTG
GCGCATTATTGCAATGCTC -> CGCATTATTGCAATGCTCT
GCAGGCGTACAGAATACCG -> CAGGCGTACAGAATACCGC
CAATCTGTGTCTACGTCTA -> AATCTGTGTCTACGTCTAC
TAATCCCAATCTGTGTCTA -> AATCCCAATCTGTGTCTAC
GGGAAGGCCCTTCCGCGGT -> GGAAGGCCCTTCCGCGGTT
GCGGATTGTGATAGACGCC -> CGGATTGTGATAGACGCCA
TAACAGCTCTCGATGGTAT -> AACAGCTCTCGATGGTATT
TTTGTCAATAAACCAACCG -> TTGTCAATAAACCAACCGT
CTCTCGATGGTATTCTGCT -> TCTCGATGGTATTCTGCTT
TTGAGAAGGCTAAGGATTC -> TGAGAAGGCTAAGGATTCT
CTTGTTCCCGACAACGTCT -> TTGTTCCCGACAACGTCTC
AACCGAGGCTCTCAGTACT -> ACCGAGGCTCTCAGTACTA
TTCTGCTACGGAACGGGCG -> TCTGCTACGGAACGGGCGC
CTACAATCGGCTCACTGAC -> TACAATCGGCTCACTGACC
CCGTTTCGTGTACCGTGAG -> CGTTTCGTGTACCGTGAGC
GGTTGACCGATCGGGTTAG -> GTTGACCGATCGGGTTAGA
AAGTATGACGAAATGCTCG -> AGTATGACGAAATGCTCGA
CTGTTAGAGCCTACAATCG -> TGTTAGAGCCTACAATCGG
CGAGGCTCTCAGTACTAGG -> GAGGCTCTCAGTACTAGGT
ACCTCGCTCATGTTCGGAA -> CCTCGCTCATGTTCGGAAC
CTGGATGTGTCTCGACTCA -> TGGATGTGTCTCGACTCAG
GGAAAGAACTAAAGCAGGC -> GAAAGAACTAAAGCAGGCG
CAAATGTTTGTCTTTTAAA -> AAATGTTTGTCTTTTAAAT
CTCTACGAACCAGTAGAAT -> TCTACGAACCAGTAGAATA
TGTGACTCCGAAGAAATCT -> GTGACTCCGAAGAAATCTA
CTACTCTGATGGTTACCTT -> TACTCTGATGGTTACCTTC
AGAGGCGGTTGGATAGCGT -> GAGGCGGTTGGATAGCGTA
GTACCCCTGTGACACGCAT -> TACCCCTGTGACACGCATC
AATCAATTATTTGTTTACA -> ATCAATTATTTGTTTACAA
CTCTGATGGTTGACCGATC -> TCTGATGGTTGACCGATCG
TTGCAATTGTTAATGGAAA -> TGCAATTGTTAATGGAAAG
GTCAGGTGATAATCCCAAT -> TCAGGTGATAATCCCAATC
GCGGCCAAGATGAACATTT -> CGGCCAAGATGAACATTTA
GCGCCAATATCCTCGAGGT -> CGCCAATATCCTCGAGGTA
ACACAGCCGTTTCGTGTAC -> CACAGCCGTTTCGTGTACC
CTGATGGTTACCTTCTGGA -> TGATGGTTACCTTCTGGAC
GGCTCTCAGTACTAGGTAC -> GCTCTCAGTACTAGGTACT
CTTGCCCCGGGACAGCGCG -> TTGCCCCGGGACAGCGCGT
CGGTCCCGGGTACTCAAGT -> GGTCCCGGGTACTCAAGTA
GAAAAGCCGTAGCGTGCAG -> AAAAGCCGTAGCGTGCAGG
ATTTCCGCTATTCGTCAAA -> TTTCCGCTATTCGTCAAAT
TGTTCCCGACAACGTCTCG -> GTTCCCGACAACGTCTCGC
GCTGGACGCCTATACACGT -> CTGGACGCCTATACACGTG
GCCTTTCAAGGCGTCGGAT -> CCTTTCAAGGCGTCGGATA
CAATTTATCTACTTATCCT -> AATTTATCTACTTATCCTA
GAGAAGGCTAAGGATTCTT -> AGAAGGCTAAGGATTCTTG
CCCGACCGACTGGACCGCC -> CCGACCGACTGGACCGCCA
CACGCGCGGCTTGGGGAAC -> ACGCGCGGCTTGGGGAACC
GTGCCCATTACAGCATGGC -> TGCCCATTACAGCATGGCA
CTACTTTCTCAGCTTGGAC -> TACTTTCTCAGCTTGGACA
TGGACCGCCATGACACAGC -> GGACCGCCATGACACAGCC
GTCTGTTAAAATGACTGCG -> TCTGTTAAAATGACTGCGG
CACCGTCATTTAAACACTA -> ACCGTCATTTAAACACTAT
TGAATTGAAAAGTCGTGGG -> GAATTGAAAAGTCGTGGGA
TCCTTCCCCAACCGTGTAT -> CCTTCCCCAACCGTGTATA
TAGCCGCACACCTGATCAT -> AGCCGCACACCTGATCATT
TATGCCTGTCGTGCGTTAC -> ATGCCTGTCGTGCGTTACC
TACTTCGGGCTAGTTATAC -> ACTTCGGGCTAGTTATACC
AACTAATTCTTTCTGCGTC -> ACTAATTCTTTCTGCGTCT
TGGCCCGTGTATAACAGCT -> GGCCCGTGTATAACAGCTC
AGCCGCACACCTGATCATT -> GCCGCACACCTGATCATTT
TCCTGCGCCTCATGATAGC -> CCTGCGCCTCATGATAGCC
CTCTGATGGTTACCTTCTG -> TCTGATGGTTACCTTCTGG
AAGGCGTCGGATACTCTGG -> AGGCGTCGGATACTCTGGA
GTGACACGCATCGGCTGGA -> TGACACGCATCGGCTGGAC
CGTGTATAACAGCTCTCGA -> GTGTATAACAGCTCTCGAT
CTGTGTAACGACCAGATAG -> TGTGTAACGACCAGATAGA
GCCCTTGTTCCCGACAACG -> CCCTTGTTCCCGACAACGT
GGAGAGCCTCTTACCTGAT -> GAGAGCCTCTTACCTGATC
TATGTCACTGGCAGTATCA -> ATGTCACTGGCAGTATCAC
GCAATTGTTAATGGAAAGT -> CAATTGTTAATGGAAAGTA
ACCGCGTAAAGCTTAATTG -> CCGCGTAAAGCTTAATTGC
TTAAAATGACTGCGGTACT -> TAAAATGACTGCGGTACTC
TGCGTCTGTTCATGCATCA -> GCGTCTGTTCATGCATCAG
CTACTCTGATGGTTTAAGA -> TACTCTGATGGTTTAAGAG
CCCGACAACGTCTCGCAAG -> CCGACAACGTCTCGCAAGT
CTGATGGTTCGCGACCTCG -> TGATGGTTCGCGACCTCGA
ATAACTGCGAGCAAGGTCA -> TAACTGCGAGCAAGGTCAG
GTAAAGCTTAATTGCTGGA -> TAAAGCTTAATTGCTGGAG
CCTGAGGTCCTGCTCGTAT -> CTGAGGTCCTGCTCGTATC
AGGTATCTGCTCAAATGTT -> GGTATCTGCTCAAATGTTT
GACTCCCCAGATACAAGCG -> ACTCCCCAGATACAAGCGT
GAAATCTAACAGAGCATGC -> AAATCTAACAGAGCATGCT
CTTGACCTTTGGCCCGTGT -> TTGACCTTTGGCCCGTGTA
AACCGTTAAAATCGGGAAA -> ACCGTTAAAATCGGGAAAG
AGATTTCCGCTATTCGTCA -> GATTTCCGCTATTCGTCAA
CGCGTAATAATGTCGCAAT -> GCGTAATAATGTCGCAATT
CGCCGACACTACACATGTA -> GCCGACACTACACATGTAG
GTATCACCGTGCGTCCACA -> TATCACCGTGCGTCCACAG
CGTAGCGTGCAGGCGTACA -> GTAGCGTGCAGGCGTACAG
AACTACCGCCCTTGTTCCC -> ACTACCGCCCTTGTTCCCG
TGATTGACTAACTACCGCC -> GATTGACTAACTACCGCCC
TTCGGAAACGCCGACACTA -> TCGGAAACGCCGACACTAC
ATTTCCGCTATTCACGGCT -> TTTCCGCTATTCACGGCTC
GTTACGCACCTTCTGCGGA -> TTACGCACCTTCTGCGGAG
TCTGTGTCTACGTCTACCA -> CTGTGTCTACGTCTACCAT
TCTTTGTCCTTTAGCCTTT -> CTTTGTCCTTTAGCCTTTC
ATCGGGAAAGAACTAAAGC -> TCGGGAAAGAACTAAAGCA
CATGCTCCGACCACGCGCG -> ATGCTCCGACCACGCGCGG
TGCATCAGCATCTGTGTAA -> GCATCAGCATCTGTGTAAC
CACCTTCTGCGGAGCACGG -> ACCTTCTGCGGAGCACGGC
TTCTTTCTGCGTCTGTTCA -> TCTTTCTGCGTCTGTTCAT
GCGTGCAGGCGTACAGAAT -> CGTGCAGGCGTACAGAATA
AACTACTCTGATGGTTACC -> ACTACTCTGATGGTTACCT
CTCGATGGTATTCTGCTTA -> TCGATGGTATTCTGCTTAG
CCCTTCTGTTAGAGCCTAC -> CCTTCTGTTAGAGCCTACA
TCGTGGGAGTCAAGGCGCA -> CGTGGGAGTCAAGGCGCAG
ATCTGGAACCTCGTACTAT -> TCTGGAACCTCGTACTATT
GTGACTCTTTGTCCTTTAG -> TGACTCTTTGTCCTTTAGC
AGACGCTTACATGAGGTCA -> GACGCTTACATGAGGTCAT
TCTCAGTACTAGGTACTCG -> CTCAGTACTAGGTACTCGC
GTAATAATGTCGCAATTGT -> TAATAATGTCGCAATTGTT
TGTGATAGACGCCACGACT -> GTGATAGACGCCACGACTC
TTGACCTTTGGCCCGTGTA -> TGACCTTTGGCCCGTGTAT
GCAAGGTCAGCCCGTCCCT -> CAAGGTCAGCCCGTCCCTT
GGCTCACTGACCTATTTCT -> GCTCACTGACCTATTTCTT
CCGGTGAGTTTAATTAGAC -> CGGTGAGTTTAATTAGACC
TGGAATCAGAACCGCCTAT -> GGAATCAGAACCGCCTATA
CAGGCGTACAGAATACCGC -> AGGCGTACAGAATACCGCG
GTGATAATCCCAATCTGTG -> TGATAATCCCAATCTGTGT
CACCTGAGGTCCTGCTCGT -> ACCTGAGGTCCTGCTCGTA
TCTAACAGAGCATGCTCCG -> CTAACAGAGCATGCTCCGA
CCCCAGATACAAGCGTCCT -> CCCAGATACAAGCGTCCTC
TATTGGAGAGCCGACGCCG -> ATTGGAGAGCCGACGCCGT
ACCGATCGGGTTAGAGATT -> CCGATCGGGTTAGAGATTT
TCTGTTAGAGCCTACAATC -> CTGTTAGAGCCTACAATCG
ATCTGCTCAAATGTTTGTC -> TCTGCTCAAATGTTTGTCT
GCAACAATTTATCTACTTA -> CAACAATTTATCTACTTAT
TGACTTGAGAAGGCTAAGG -> GACTTGAGAAGGCTAAGGA
TGACTCTTTGTCCTTTAGC -> GACTCTTTGTCCTTTAGCC
TTCATGACTTCACAGAGTG -> TCATGACTTCACAGAGTGA
TGTTCATTTATGTAGGCGG -> GTTCATTTATGTAGGCGGT
TATAGCTGTTACCGTGGAC -> ATAGCTGTTACCGTGGACG
TCAATCAATTATTTGTTTA -> CAATCAATTATTTGTTTAC
CTTCCCCAACCGTGTATAC -> TTCCCCAACCGTGTATACT
GTGAGCTTGTCAGGTGATA -> TGAGCTTGTCAGGTGATAA
TGAAGCACGAGCCGAGACG -> GAAGCACGAGCCGAGACGC
CCAGTAGAATAGACTTGCT -> CAGTAGAATAGACTTGCTA
CGAGGTACTGCTTTCTGCT -> GAGGTACTGCTTTCTGCTA
CCGTGAAGCACGAGCCGAG -> CGTGAAGCACGAGCCGAGA
GCTATTCAATCCGGACTAG -> CTATTCAATCCGGACTAGA
ATTATTTGTTTACAAGATA -> TTATTTGTTTACAAGATAA
TACTCTCTACGAACCAGTA -> ACTCTCTACGAACCAGTAG
TGGTATTCTGCTTAGGGAA -> GGTATTCTGCTTAGGGAAG
GAACCTCGTACTATTTTGT -> AACCTCGTACTATTTTGTC
AGGCCCACGATCTATTGTT -> GGCCCACGATCTATTGTTC
TGTTTGTCTTTTAAATAGG -> GTTTGTCTTTTAAATAGGG
TTTTGTCAATAAACCAACC -> TTTGTCAATAAACCAACCG
GGTACTGCTTTCTGCTACG -> GTACTGCTTTCTGCTACGG
GACCAGATAGAAACTACTC -> ACCAGATAGAAACTACTCT
CTTACCTGATCTAGCCTGA -> TTACCTGATCTAGCCTGAT
AGTTACGCACCTTCTGCGG -> GTTACGCACCTTCTGCGGA
TGATGGTTACCTTCTGGAC -> GATGGTTACCTTCTGGACT
CCATTGAAACTCGAACATA -> CATTGAAACTCGAACATAT
CTACTCTGATGGTTCGCGA -> TACTCTGATGGTTCGCGAC
GTGTATAACAGCTCTCGAT -> TGTATAACAGCTCTCGATG
TCGCCGTATCACCGTGCGT -> CGCCGTATCACCGTGCGTC
CTTTTAAATAGGGATTTTA -> TTTTAAATAGGGATTTTAT
CAAGTCCGTCTTCAGGCGC -> AAGTCCGTCTTCAGGCGCC
CGACAGAGATGGTCGCGAT -> GACAGAGATGGTCGCGATG
CTAATGAGACCCGGCCGAA -> TAATGAGACCCGGCCGAAC
GTAGGGTGGACTATTGGAA -> TAGGGTGGACTATTGGAAT
CGACGCCGTCGAAACTACT -> GACGCCGTCGAAACTACTC
AAATGTCTAGCTTCGCATC -> AATGTCTAGCTTCGCATCT
TCAAGTGCCCATTACAGCA -> CAAGTGCCCATTACAGCAT
TTGTCAGGTGATAATCCCA -> TGTCAGGTGATAATCCCAA
TCCCCAGATACAAGCGTCC -> CCCCAGATACAAGCGTCCT
CCCGGCCGAACACTTCCTG -> CCGGCCGAACACTTCCTGC
AGGTCCTGCTCGTATCAGT -> GGTCCTGCTCGTATCAGTG
GCATGCTCCGACCACGCGC -> CATGCTCCGACCACGCGCG
GTCTACCATGTTCATGACT -> TCTACCATGTTCATGACTT
ATTACTTCGGGCTAGTTAT -> TTACTTCGGGCTAGTTATA
GGTGGACTATTGGAATCAG -> GTGGACTATTGGAATCAGA
CGCCGTATCACCGTGCGTC -> GCCGTATCACCGTGCGTCC
AACTTTGCAATTGTTAATG -> ACTTTGCAATTGTTAATGG
ACAGCCGTTTCGTGTACCG -> CAGCCGTTTCGTGTACCGT
ACGCATGCGGATTGTGATA -> CGCATGCGGATTGTGATAG
GAATGCTAATCAATCAATT -> AATGCTAATCAATCAATTA
GGAACTAATTCTTTCTGCG -> GAACTAATTCTTTCTGCGT
AGGCCTTTAGTCTCACACC -> GGCCTTTAGTCTCACACCT
GCCATGACACAGCCGTTTC -> CCATGACACAGCCGTTTCG
AAGCGTCCTCAAGTGCCCA -> AGCGTCCTCAAGTGCCCAT
CCTGCGCCTCATGATAGCC -> CTGCGCCTCATGATAGCCG
CGGGCTAGTTATACCAAGA -> GGGCTAGTTATACCAAGAT
AGAGGACGCATGCGGATTG -> GAGGACGCATGCGGATTGT
CACTTCCTGCGCCTCATGA -> ACTTCCTGCGCCTCATGAT
TGCTTAGTAAAGAGATCTG -> GCTTAGTAAAGAGATCTGG
AAATGCTCGAGGGACGGTA -> AATGCTCGAGGGACGGTAA
ACTTCACAGAGTGACATTA -> CTTCACAGAGTGACATTAT
CCTCCGAGACTATCACCGG -> CTCCGAGACTATCACCGGT
CTGCGGTACTCTCTACGAA -> TGCGGTACTCTCTACGAAC
TATCAGTGCGTGCCCTTTC -> ATCAGTGCGTGCCCTTTCG
CTCTCAGGGAGAAGGCCCA -> TCTCAGGGAGAAGGCCCAC
TCAGCTTGGACAAAACCGA -> CAGCTTGGACAAAACCGAG
CCGAGACGCTTACATGAGG -> CGAGACGCTTACATGAGGT
GCCACGACTCCCCAGATAC -> CCACGACTCCCCAGATACA
ACAGAGTGACATTATGTCA -> CAGAGTGACATTATGTCAC
GAGACCCGGCCGAACACTT -> AGACCCGGCCGAACACTTC
CACGATCTATTGTTCATTT -> ACGATCTATTGTTCATTTA
TTTTATGCCTGTCGTGCGT -> TTTATGCCTGTCGTGCGTT
TGATCTAGCCTGATCAAAT -> GATCTAGCCTGATCAAATT
ACAGAGATGGTCGCGATGT -> CAGAGATGGTCGCGATGTG
GGGTTAGAGATTTCCGCTA -> GGTTAGAGATTTCCGCTAT
AGAGATTTCCGCTATTCGT -> GAGATTTCCGCTATTCGTC
GTACAGAATACCGCGTAAA -> TACAGAATACCGCGTAAAG
CTTTGCAATTGTTAATGGA -> TTTGCAATTGTTAATGGAA
TAGCCTGATCAAATTACTT -> AGCCTGATCAAATTACTTC
CTCAAAGTCGGACTCGCTA -> TCAAAGTCGGACTCGCTAA
CGGGCAACAATTTATCTAC -> GGGCAACAATTTATCTACT
AAACACTATTGGAGAGCCG -> AACACTATTGGAGAGCCGA
AGTCGGACTCGCTAACCAT -> GTCGGACTCGCTAACCATT
TTTCTGCGTCTGTTCATGC -> TTCTGCGTCTGTTCATGCA
CCTTTAGTCTCACACCTGA -> CTTTAGTCTCACACCTGAG
ACGCCGTCGAAACTACTCT -> CGCCGTCGAAACTACTCTG
CCTTGTTCCCGACAACGTC -> CTTGTTCCCGACAACGTCT
CTGTTAAAATGACTGCGGT -> TGTTAAAATGACTGCGGTA
CATTACAGCATGGCAGAAG -> ATTACAGCATGGCAGAAGC
ACAGCATGGCAGAAGCCAT -> CAGCATGGCAGAAGCCATG
GGACGCATGCGGATTGTGA -> GACGCATGCGGATTGTGAT
CTCGAGGGACGGTAAGCTA -> TCGAGGGACGGTAAGCTAT
GTGCAGGCGTACAGAATAC -> TGCAGGCGTACAGAATACC
GCACGAGCCGAGACGCTTA -> CACGAGCCGAGACGCTTAC
CGCTGACTTGAGAAGGCTA -> GCTGACTTGAGAAGGCTAA
ATAAAATTGACCCGACCGA -> TAAAATTGACCCGACCGAC
GCCCTTTCGGAAACGCCGA -> CCCTTTCGGAAACGCCGAC
TCTTTTAAATAGGGATTTT -> CTTTTAAATAGGGATTTTA
TAACTACCGCCCTTGTTCC -> AACTACCGCCCTTGTTCCC
TGCGTGCCCTTTCGGAAAC -> GCGTGCCCTTTCGGAAACG
CCTCGTACTATTTTGTCAA -> CTCGTACTATTTTGTCAAT
ACAGCTCTCGATGGTATTC -> CAGCTCTCGATGGTATTCT
CCCATTACAGCATGGCAGA -> CCATTACAGCATGGCAGAA
CGACTGGACCGCCATGACA -> GACTGGACCGCCATGACAC
AAAGAGATCTGGAACCTCG -> AAGAGATCTGGAACCTCGT
CAAGTATGACGAAATGCTC -> AAGTATGACGAAATGCTCG
CGATCTATTGTTCATTTAT -> GATCTATTGTTCATTTATG
ACCGTCATTTAAACACTAT -> CCGTCATTTAAACACTATT
CTATTGTTCATTTATGTAG -> TATTGTTCATTTATGTAGG
CATGCGGATTGTGATAGAC -> ATGCGGATTGTGATAGACG
GTCCATCAGCACCGTCATT -> TCCATCAGCACCGTCATTT
GAGCCTCTTACCTGATCTA -> AGCCTCTTACCTGATCTAG
AACCGTGTATACTCAAAGT -> ACCGTGTATACTCAAAGTC
CTGGACTTAGAGATTTCCG -> TGGACTTAGAGATTTCCGC
ACTTGAGAAGGCTAAGGAT -> CTTGAGAAGGCTAAGGATT
TGAACATTTAAACTTTGCA -> GAACATTTAAACTTTGCAA
GGTGAGTTTAATTAGACCT -> GTGAGTTTAATTAGACCTG
TGTCACTGGCAGTATCACT -> GTCACTGGCAGTATCACTT
ACTCTGATGGTTGACCGAT -> CTCTGATGGTTGACCGATC
TGGACTTAGAGATTTCCGC -> GGACTTAGAGATTTCCGCT
ATGGTTTAAGAGAAGCGTT -> TGGTTTAAGAGAAGCGTTA
GAGGTCCTGCTCGTATCAG -> AGGTCCTGCTCGTATCAGT
TCAGAACCGCCTATAGCTG -> CAGAACCGCCTATAGCTGT
AACAGAGCATGCTCCGACC -> ACAGAGCATGCTCCGACCA
TCAAATTACTTCGGGCTAG -> CAAATTACTTCGGGCTAGT
TTTCGTGTACCGTGAGCTT -> TTCGTGTACCGTGAGCTTG
TACGCACCTTCTGCGGAGC -> ACGCACCTTCTGCGGAGCA
CCGTGCGTCCACAGGATGA -> CGTGCGTCCACAGGATGAT
CCTTCCGCGGTTGAACCCG -> CTTCCGCGGTTGAACCCGG
GTAAGCTATTCTACTTTCT -> TAAGCTATTCTACTTTCTC
GTCATTTAAACACTATTGG -> TCATTTAAACACTATTGGA
AATTTATCTACTTATCCTA -> ATTTATCTACTTATCCTAA
ACTTTCTCAGCTTGGACAA -> CTTTCTCAGCTTGGACAAA
ATTATTGCAATGCTCTAGC -> TTATTGCAATGCTCTAGCA
CGGATTGTGATAGACGCCA -> GGATTGTGATAGACGCCAC
TCCGTGAAGCACGAGCCGA -> CCGTGAAGCACGAGCCGAG
CTAACTACCGCCCTTGTTC -> TAACTACCGCCCTTGTTCC
TATTCAATCCGGACTAGAG -> ATTCAATCCGGACTAGAGG
ACAGGATGATTGACTAACT -> CAGGATGATTGACTAACTA
GCGCGTAATAATGTCGCAA -> CGCGTAATAATGTCGCAAT
GAGAGCCGACGCCGTCGAA -> AGAGCCGACGCCGTCGAAA
CCACGATCTATTGTTCATT -> CACGATCTATTGTTCATTT
CACCTGATCATTTGCGTTA -> ACCTGATCATTTGCGTTAG
GAGCCGACGCCGTCGAAAC -> AGCCGACGCCGTCGAAACT
ACGCGCGGCTTGGGGAACC -> CGCGCGGCTTGGGGAACCC
TCTGATGGTTGACCGATCG -> CTGATGGTTGACCGATCGG
CTTTCGGAAACGCCGACAC -> TTTCGGAAACGCCGACACT
GTCAATAAACCAACCGTTA -> TCAATAAACCAACCGTTAA
GGTTACCTTCTGGACTTAG -> GTTACCTTCTGGACTTAGA
TCGAGGTACTGCTTTCTGC -> CGAGGTACTGCTTTCTGCT
AAGGCTAAGGATTCTTGAC -> AGGCTAAGGATTCTTGACC
AGCATCTGTGTAACGACCA -> GCATCTGTGTAACGACCAG
ACCGTGGACGGAATGCTAA -> CCGTGGACGGAATGCTAAT
GAACTAAAGCAGGCGGGCA -> AACTAAAGCAGGCGGGCAA
GCTCAAATGTTTGTCTTTT -> CTCAAATGTTTGTCTTTTA
CGATCGGGTTAGAGATTTC -> GATCGGGTTAGAGATTTCC
CTCATGTGACTCTTTGTCC -> TCATGTGACTCTTTGTCCT
ACTAGAGGACGCATGCGGA -> CTAGAGGACGCATGCGGAT
CACATGTAAGAGGCGGTTG -> ACATGTAAGAGGCGGTTGG
GTAGAATAGACTTGCTAGG -> TAGAATAGACTTGCTAGGA
CATGTTCGGAACAAGCTGA -> ATGTTCGGAACAAGCTGAA
TGCGGATTGTGATAGACGC -> GCGGATTGTGATAGACGCC
GTACTATTTTGTCAATAAA -> TACTATTTTGTCAATAAAC
ACGTCTACCATGTTCATGA -> CGTCTACCATGTTCATGAC
ATTCAATCCGGACTAGAGG -> TTCAATCCGGACTAGAGGA
AAACCGAGGCTCTCAGTAC -> AACCGAGGCTCTCAGTACT
GGCTAAGGATTCTTGACCT -> GCTAAGGATTCTTGACCTT
TTATGTAGGCGGTCCCGGG -> TATGTAGGCGGTCCCGGGT
CTGACCTATTTCTTTACTG -> TGACCTATTTCTTTACTGT
GAATAGACTTGCTAGGAAC -> AATAGACTTGCTAGGAACC
CCTGATCTAGCCTGATCAA -> CTGATCTAGCCTGATCAAA
AATCAGAACCGCCTATAGC -> ATCAGAACCGCCTATAGCT
TTGGCCCGTGTATAACAGC -> TGGCCCGTGTATAACAGCT
CGGTAAGCTATTCTACTTT -> GGTAAGCTATTCTACTTTC
CGTGCCCTTTCGGAAACGC -> GTGCCCTTTCGGAAACGCC
GCGTTACCCTGCGCTGACT -> CGTTACCCTGCGCTGACTT
ATCTGTGTCTACGTCTACC -> TCTGTGTCTACGTCTACCA
GCGGTACTCTCTACGAACC -> CGGTACTCTCTACGAACCA
GGGTACTCAAGTATGACGA -> GGTACTCAAGTATGACGAA
CAGGATGATTGACTAACTA -> AGGATGATTGACTAACTAC
TCAATTATTTGTTTACAAG -> CAATTATTTGTTTACAAGA
CGATGGTATTCTGCTTAGG -> GATGGTATTCTGCTTAGGG
GGACGCCTATACACGTGTG -> GACGCCTATACACGTGTGA
TGTAAGAGGCGGTTGGATA -> GTAAGAGGCGGTTGGATAG
GTGAGTTACGCACCTTCTG -> TGAGTTACGCACCTTCTGC
AGAACTAAAGCAGGCGGGC -> GAACTAAAGCAGGCGGGCA
TTAAGCTTGCCCCGGGACA -> TAAGCTTGCCCCGGGACAG
ATTGTTCATTTATGTAGGC -> TTGTTCATTTATGTAGGCG
TCTAGCCTGATCAAATTAC -> CTAGCCTGATCAAATTACT
ATAGCGTATGTCCATCAGC -> TAGCGTATGTCCATCAGCA
CGCCCTTGTTCCCGACAAC -> GCCCTTGTTCCCGACAACG
TTACAGCATGGCAGAAGCC -> TACAGCATGGCAGAAGCCA
TTTACTGTCTGTTAAAATG -> TTACTGTCTGTTAAAATGA
AGGAACCCTCCGAGACTAT -> GGAACCCTCCGAGACTATC
TCCTCAAGTGCCCATTACA -> CCTCAAGTGCCCATTACAG
CCCTCCGAGACTATCACCG -> CCTCCGAGACTATCACCGG
TATCACCGGTGAGTTTAAT -> ATCACCGGTGAGTTTAATT
TGCTCGAGGGACGGTAAGC -> GCTCGAGGGACGGTAAGCT
CCAGATACAAGCGTCCTCA -> CAGATACAAGCGTCCTCAA
TAGAGATTTCCGCTATTCT -> AGAGATTTCCGCTATTCTG
GCGTAAAGCTTAATTGCTG -> CGTAAAGCTTAATTGCTGG
TCGGTGAGTTACGCACCTT -> CGGTGAGTTACGCACCTTC
AATGACTGCGGTACTCTCT -> ATGACTGCGGTACTCTCTA
GTCTGGGCTAGTCAATCTA -> TCTGGGCTAGTCAATCTAC
ACCGTGAGCTTGTCAGGTG -> CCGTGAGCTTGTCAGGTGA
CGCTATTCTGGATGTGTCT -> GCTATTCTGGATGTGTCTC
TTTGTTTACAAGATAAAAT -> TTGTTTACAAGATAAAATT
GTTACCCTGCGCTGACTTG -> TTACCCTGCGCTGACTTGA
GCTCGGTGAGTTACGCACC -> CTCGGTGAGTTACGCACCT
CTATCACCGGTGAGTTTAA -> TATCACCGGTGAGTTTAAT
AATAGGGATTTTATGCCTG -> ATAGGGATTTTATGCCTGT
CTTTCTGCTACGGAACGGG -> TTTCTGCTACGGAACGGGC
ATGACTGCGGTACTCTCTA -> TGACTGCGGTACTCTCTAC
CCACGACTCCCCAGATACA -> CACGACTCCCCAGATACAA
TCATGACTTCACAGAGTGA -> CATGACTTCACAGAGTGAC
TTAAAATCGGGAAAGAACT -> TAAAATCGGGAAAGAACTA
GCTTACATGAGGTCATGCG -> CTTACATGAGGTCATGCGA
AGATCTGGAACCTCGTACT -> GATCTGGAACCTCGTACTA
ACATGTAAGAGGCGGTTGG -> CATGTAAGAGGCGGTTGGA
ATGAATTGAAAAGTCGTGG -> TGAATTGAAAAGTCGTGGG
GGCGCAGCCAACTTACTCA -> GCGCAGCCAACTTACTCAT
ACTCTCTACGAACCAGTAG -> CTCTCTACGAACCAGTAGA
TTTCTTTACTGTCTGTTAA -> TTCTTTACTGTCTGTTAAA
AGGCGGTCCCGGGTACTCA -> GGCGGTCCCGGGTACTCAA
GGCCTTTAGTCTCACACCT -> GCCTTTAGTCTCACACCTG
TTACAAGATAAAATTGACC -> TACAAGATAAAATTGACCC
CGTATCAGTGCGTGCCCTT -> GTATCAGTGCGTGCCCTTT
CCTCTTACCTGATCTAGCC -> CTCTTACCTGATCTAGCCT
CAGCGCGTAATAATGTCGC -> AGCGCGTAATAATGTCGCA
CAATCCGGACTAGAGGACG -> AATCCGGACTAGAGGACGC
CTGGAACCTCGTACTATTT -> TGGAACCTCGTACTATTTT
ATAAACCAACCGTTAAAAT -> TAAACCAACCGTTAAAATC
TTGACCCGACCGACTGGAC -> TGACCCGACCGACTGGACC
GGATACTCTGGAACTAATT -> GATACTCTGGAACTAATTC
CAGCATCTGTGTAACGACC -> AGCATCTGTGTAACGACCA
AGGGACGGTAAGCTATTCT -> GGGACGGTAAGCTATTCTA
GCCTGTCGTGCGTTACCCT -> CCTGTCGTGCGTTACCCTG
TATTCTACTTTCTCAGCTT -> ATTCTACTTTCTCAGCTTG
CATTTAAACACTATTGGAG -> ATTTAAACACTATTGGAGA
TCAGCATCTGTGTAACGAC -> CAGCATCTGTGTAACGACC
TGACCTTTGGCCCGTGTAT -> GACCTTTGGCCCGTGTATA
TGTTACCGTGGACGGAATG -> GTTACCGTGGACGGAATGC
GAACGGGCGCATTATTGCA -> AACGGGCGCATTATTGCAA
CCATGTCTGGGCTAGTCAA -> CATGTCTGGGCTAGTCAAT
ACTACTCTGATGGTTGACC -> CTACTCTGATGGTTGACCG
CTCAAATGTTTGTCTTTTA -> TCAAATGTTTGTCTTTTAA
ATTTATCTACTTATCCTAA -> TTTATCTACTTATCCTAAT
CTCGAACATATGAATTGAA -> TCGAACATATGAATTGAAA
TTTCTGCTACGGAACGGGC -> TTCTGCTACGGAACGGGCG
TATACCAAGATATCAAGGC -> ATACCAAGATATCAAGGCC
ACGGAATGCTAATCAATCA -> CGGAATGCTAATCAATCAA
TCAGGTATCTGCTCAAATG -> CAGGTATCTGCTCAAATGT
TATGTCCATCAGCACCGTC -> ATGTCCATCAGCACCGTCA
ATTCTGCTTAGGGAAGGCC -> TTCTGCTTAGGGAAGGCCC
GAGACGCTTACATGAGGTC -> AGACGCTTACATGAGGTCA
TCTAGCTTCGCATCTCTCA -> CTAGCTTCGCATCTCTCAG
ACCTGAGGTCCTGCTCGTA -> CCTGAGGTCCTGCTCGTAT
GACCTTACCTCGCTCATGT -> ACCTTACCTCGCTCATGTT
AGACGCCACGACTCCCCAG -> GACGCCACGACTCCCCAGA
CATTATGTCACTGGCAGTA -> ATTATGTCACTGGCAGTAT
AAGTCCGTCTTCAGGCGCC -> AGTCCGTCTTCAGGCGCCA
CTCAAGTGCCCATTACAGC -> TCAAGTGCCCATTACAGCA
CTTGCTAGGAACCCTCCGA -> TTGCTAGGAACCCTCCGAG
AAGCTTGCCCCGGGACAGC -> AGCTTGCCCCGGGACAGCG
AATAATGTCGCAATTGTTG -> ATAATGTCGCAATTGTTGG
TGGACGGAATGCTAATCAA -> GGACGGAATGCTAATCAAT
TTCCGCGGTTGAACCCGGA -> TCCGCGGTTGAACCCGGAA
CTTCGCATCTCTCAGGGAG -> TTCGCATCTCTCAGGGAGA
CCGAGACTATCACCGGTGA -> CGAGACTATCACCGGTGAG
GGCGTCGGATACTCTGGAA -> GCGTCGGATACTCTGGAAC
AAATCTAACAGAGCATGCT -> AATCTAACAGAGCATGCTC
ATTGTTGGTGTGACTCCGA -> TTGTTGGTGTGACTCCGAA
TAATTCTTTCTGCGTCTGT -> AATTCTTTCTGCGTCTGTT
AGATACAAGCGTCCTCAAG -> GATACAAGCGTCCTCAAGT
GGCTGGACGCCTATACACG -> GCTGGACGCCTATACACGT
TAGGGTGGACTATTGGAAT -> AGGGTGGACTATTGGAATC
GATGGTTTAAGAGAAGCGT -> ATGGTTTAAGAGAAGCGTT
GTCACTGGCAGTATCACTT -> TCACTGGCAGTATCACTTC
TCAATAAACCAACCGTTAA -> CAATAAACCAACCGTTAAA
CGACCACGCGCGGCTTGGG -> GACCACGCGCGGCTTGGGG
ACATTTAAACTTTGCAATT -> CATTTAAACTTTGCAATTG
CCTGATCAAATTACTTCGG -> CTGATCAAATTACTTCGGG
CAAGGTCAGCCCGTCCCTT -> AAGGTCAGCCCGTCCCTTC
ATACCAAGATATCAAGGCC -> TACCAAGATATCAAGGCCT
TTAGCCTTTCAAGGCGTCG -> TAGCCTTTCAAGGCGTCGG
TGCGCTGACTTGAGAAGGC -> GCGCTGACTTGAGAAGGCT
GCGGCTTGGGGAACCCACC -> CGGCTTGGGGAACCCACCG
TGGTGTGACTCCGAAGAAA -> GGTGTGACTCCGAAGAAAT
GCATAACCCTCTCTACGTG -> CATAACCCTCTCTACGTGT
GGCTTCCGTGAAGCACGAG -> GCTTCCGTGAAGCACGAGC
TTGTTAATGGAAAGTACCC -> TGTTAATGGAAAGTACCCC
TGCTTAGGGAAGGCCCTTC -> GCTTAGGGAAGGCCCTTCC
AATCAATCAATTATTTGTT -> ATCAATCAATTATTTGTTT
GATTTCCGCTATTCACGGC -> ATTTCCGCTATTCACGGCT
GATGAACATTTAAACTTTG -> ATGAACATTTAAACTTTGC
TTTCGGAAACGCCGACACT -> TTCGGAAACGCCGACACTA
GTTAAAATGACTGCGGTAC -> TTAAAATGACTGCGGTACT
ATTTTGTCAATAAACCAAC -> TTTTGTCAATAAACCAACC
TGAGTTACGCACCTTCTGC -> GAGTTACGCACCTTCTGCG
AGGGTGGACTATTGGAATC -> GGGTGGACTATTGGAATCA
GGACGGAATGCTAATCAAT -> GACGGAATGCTAATCAATC
AGGTACTCGCCGTATCACC -> GGTACTCGCCGTATCACCG
ATACTCAAAGTCGGACTCG -> TACTCAAAGTCGGACTCGC
GTATAACAGCTCTCGATGG -> TATAACAGCTCTCGATGGT
CATCGGCTGGACGCCTATA -> ATCGGCTGGACGCCTATAC
GGATTCTTGACCTTTGGCC -> GATTCTTGACCTTTGGCCC
GCATCAGCATCTGTGTAAC -> CATCAGCATCTGTGTAACG
ACTGCTTTCTGCTACGGAA -> CTGCTTTCTGCTACGGAAC
TCGGCTGGACGCCTATACA -> CGGCTGGACGCCTATACAC
GCTATTCTACTTTCTCAGC -> CTATTCTACTTTCTCAGCT
AAGCACGAGCCGAGACGCT -> AGCACGAGCCGAGACGCTT
CATGTTCATGACTTCACAG -> ATGTTCATGACTTCACAGA
GATGTGCTTAGTAAAGAGA -> ATGTGCTTAGTAAAGAGAT
TACTCGCCGTATCACCGTG -> ACTCGCCGTATCACCGTGC
TCCGCTATTCACGGCTCGG -> CCGCTATTCACGGCTCGGT
TTCGCGACCTCGATTAGAG -> TCGCGACCTCGATTAGAGA
AGCTGTTACCGTGGACGGA -> GCTGTTACCGTGGACGGAA
ATACCGCGTAAAGCTTAAT -> TACCGCGTAAAGCTTAATT
TAACCATTGAAACTCGAAC -> AACCATTGAAACTCGAACA
GCTACGGAACGGGCGCATT -> CTACGGAACGGGCGCATTA
GATAAAATTGACCCGACCG -> ATAAAATTGACCCGACCGA
ATGGTTCGCGACCTCGATT -> TGGTTCGCGACCTCGATTA
ATGGTTACCTTCTGGACTT -> TGGTTACCTTCTGGACTTA
TGGAAAGTACCCCTGTGAC -> GGAAAGTACCCCTGTGACA
GACCCGACCGACTGGACCG -> ACCCGACCGACTGGACCGC
CTTGAGAAGGCTAAGGATT -> TTGAGAAGGCTAAGGATTC
ATCCTCGAGGTACTGCTTT -> TCCTCGAGGTACTGCTTTC
CTATTCTGGATGTGTCTCG -> TATTCTGGATGTGTCTCGA
GCCTACAATCGGCTCACTG -> CCTACAATCGGCTCACTGA
GAGATTTCCGCTATTCACG -> AGATTTCCGCTATTCACGG
AGAATAGACTTGCTAGGAA -> GAATAGACTTGCTAGGAAC
TTTAGCCTTTCAAGGCGTC -> TTAGCCTTTCAAGGCGTCG
GAACCAGTAGAATAGACTT -> AACCAGTAGAATAGACTTG
CTACCGCCCTTGTTCCCGA -> TACCGCCCTTGTTCCCGAC
TCGCTCATGTTCGGAACAA -> CGCTCATGTTCGGAACAAG
TGCCCTTTCGGAAACGCCG -> GCCCTTTCGGAAACGCCGA
TGTTTAAGCTTGCCCCGGG -> GTTTAAGCTTGCCCCGGGA
ATAGACTTGCTAGGAACCC -> TAGACTTGCTAGGAACCCT
ACCCTGCGCTGACTTGAGA -> CCCTGCGCTGACTTGAGAA
ACTATTGGAGAGCCGACGC -> CTATTGGAGAGCCGACGCC
CTCGACTCAGGTATCTGCT -> TCGACTCAGGTATCTGCTC
GTGCCCTTTCGGAAACGCC -> TGCCCTTTCGGAAACGCCG
CCGGAAAAGCCGTAGCGTG -> CGGAAAAGCCGTAGCGTGC
CGCTTACATGAGGTCATGC -> GCTTACATGAGGTCATGCG
ATTTCCGCTATTCTGGATG -> TTTCCGCTATTCTGGATGT
CGGCTTCCGTGAAGCACGA -> GGCTTCCGTGAAGCACGAG
AGTCAATCTACTCCTTCCC -> GTCAATCTACTCCTTCCCC
ACGTCTCGCAAGTCCGTCT -> CGTCTCGCAAGTCCGTCTT
TCGTGCGTTACCCTGCGCT -> CGTGCGTTACCCTGCGCTG
ACTCTTTGTCCTTTAGCCT -> CTCTTTGTCCTTTAGCCTT
AATACCGCGTAAAGCTTAA -> ATACCGCGTAAAGCTTAAT
TTAGAGCCTACAATCGGCT -> TAGAGCCTACAATCGGCTC
GATCAAATTACTTCGGGCT -> ATCAAATTACTTCGGGCTA
AAACTACTCTGATGGTTTA -> AACTACTCTGATGGTTTAA
AACCTCGTACTATTTTGTC -> ACCTCGTACTATTTTGTCA
GGCAGAAGCCATGTCTGGG -> GCAGAAGCCATGTCTGGGC
AAAGCTTAATTGCTGGAGA -> AAGCTTAATTGCTGGAGAG
GTGACCTTACCTCGCTCAT -> TGACCTTACCTCGCTCATG
TAAGCTTGCCCCGGGACAG -> AAGCTTGCCCCGGGACAGC
TGACCTATTTCTTTACTGT -> GACCTATTTCTTTACTGTC
CTAAAGCAGGCGGGCAACA -> TAAAGCAGGCGGGCAACAA
CAATCGGCTCACTGACCTA -> AATCGGCTCACTGACCTAT
AAGAAATCTAACAGAGCAT -> AGAAATCTAACAGAGCATG
AATGGAAAGTACCCCTGTG -> ATGGAAAGTACCCCTGTGA
TCATGCGAAAGTATCGCTC -> CATGCGAAAGTATCGCTCA
TTGCCCCGGGACAGCGCGT -> TGCCCCGGGACAGCGCGTA
CAGTGCGTGCCCTTTCGGA -> AGTGCGTGCCCTTTCGGAA
CCATGACACAGCCGTTTCG -> CATGACACAGCCGTTTCGT
AAAGCAGGCGGGCAACAAT -> AAGCAGGCGGGCAACAATT
AATAGACTTGCTAGGAACC -> ATAGACTTGCTAGGAACCC
GTTCGGAACAAGCTGAAAC -> TTCGGAACAAGCTGAAACT
GCCGACGCCGTCGAAACTA -> CCGACGCCGTCGAAACTAC
ACTATCACCGGTGAGTTTA -> CTATCACCGGTGAGTTTAA
TGTCTTTTAAATAGGGATT -> GTCTTTTAAATAGGGATTT
TAACTGCGAGCAAGGTCAG -> AACTGCGAGCAAGGTCAGC
CGGAAAAGCCGTAGCGTGC -> GGAAAAGCCGTAGCGTGCA
CGGAATGCTAATCAATCAA -> GGAATGCTAATCAATCAAT
CACCGTGCGTCCACAGGAT -> ACCGTGCGTCCACAGGATG
TATTTTGTCAATAAACCAA -> ATTTTGTCAATAAACCAAC
TACACGTGTGACCTTACCT -> ACACGTGTGACCTTACCTC
GATCTAGCCTGATCAAATT -> ATCTAGCCTGATCAAATTA
ACGTGTGACCTTACCTCGC -> CGTGTGACCTTACCTCGCT
TCGCGACCTCGATTAGAGA -> CGCGACCTCGATTAGAGAT
CTCTCTACGAACCAGTAGA -> TCTCTACGAACCAGTAGAA
CCGGCCGAACACTTCCTGC -> CGGCCGAACACTTCCTGCG
CTGGAACTAATTCTTTCTG -> TGGAACTAATTCTTTCTGC
AGTTATACCAAGATATCAA -> GTTATACCAAGATATCAAG
AAAATTGACCCGACCGACT -> AAATTGACCCGACCGACTG
ATCACTTCTCGACAGAGAT -> TCACTTCTCGACAGAGATG
TGTGACACGCATCGGCTGG -> GTGACACGCATCGGCTGGA
CGCCACGACTCCCCAGATA -> GCCACGACTCCCCAGATAC
TAAAGAGATCTGGAACCTC -> AAAGAGATCTGGAACCTCG
GCTTAGTAAAGAGATCTGG -> CTTAGTAAAGAGATCTGGA
TCTCGACAGAGATGGTCGC -> CTCGACAGAGATGGTCGCG
CTTTGGCCCGTGTATAACA -> TTTGGCCCGTGTATAACAG
GCCGAGACGCTTACATGAG -> CCGAGACGCTTACATGAGG
TGGCAGTATCACTTCTCGA -> GGCAGTATCACTTCTCGAC
TACTCCTTCCCCAACCGTG -> ACTCCTTCCCCAACCGTGT
TCTGCGTCTGTTCATGCAT -> CTGCGTCTGTTCATGCATC
GCCGTAGCGTGCAGGCGTA -> CCGTAGCGTGCAGGCGTAC
TTGGAGAGCCGACGCCGTC -> TGGAGAGCCGACGCCGTCG
CTCACTGACCTATTTCTTT -> TCACTGACCTATTTCTTTA
GATCATTTGCGTTAGCATA -> ATCATTTGCGTTAGCATAA
GTTTCGTGTACCGTGAGCT -> TTTCGTGTACCGTGAGCTT
CTGACTTGAGAAGGCTAAG -> TGACTTGAGAAGGCTAAGG
GATTGTGATAGACGCCACG -> ATTGTGATAGACGCCACGA
GGCCCACGATCTATTGTTC -> GCCCACGATCTATTGTTCA
ATGATAGCCGCACACCTGA -> TGATAGCCGCACACCTGAT
GCCCTTCCGCGGTTGAACC -> CCCTTCCGCGGTTGAACCC
CAGCCGTTTCGTGTACCGT -> AGCCGTTTCGTGTACCGTG
CTTCTGGACTTAGAGATTT -> TTCTGGACTTAGAGATTTC
TTATTTGTTTACAAGATAA -> TATTTGTTTACAAGATAAA
GACGAAATGCTCGAGGGAC -> ACGAAATGCTCGAGGGACG
CTATTGGAGAGCCGACGCC -> TATTGGAGAGCCGACGCCG
CAATCAATTATTTGTTTAC -> AATCAATTATTTGTTTACA
TTGTTCATTTATGTAGGCG -> TGTTCATTTATGTAGGCGG
CGTCTTCAGGCGCCAATAT -> GTCTTCAGGCGCCAATATC
GAAACTACTCTGATGGTTT -> AAACTACTCTGATGGTTTA
TAATGAGACCCGGCCGAAC -> AATGAGACCCGGCCGAACA
TACCTGATCTAGCCTGATC -> ACCTGATCTAGCCTGATCA
GTTACCTTCTGGACTTAGA -> TTACCTTCTGGACTTAGAG
GTCCGTCTTCAGGCGCCAA -> TCCGTCTTCAGGCGCCAAT
AATCCGGACTAGAGGACGC -> ATCCGGACTAGAGGACGCA
GCTTGGACAAAACCGAGGC -> CTTGGACAAAACCGAGGCT
TTACCTTCTGGACTTAGAG -> TACCTTCTGGACTTAGAGA
ATTTGCGTTAGCATAACCC -> TTTGCGTTAGCATAACCCT
ACTCAAAGTCGGACTCGCT -> CTCAAAGTCGGACTCGCTA
ATTTAAACTTTGCAATTGT -> TTTAAACTTTGCAATTGTT
GCTATTCACGGCTCGGTGA -> CTATTCACGGCTCGGTGAG
TTAGCATAACCCTCTCTAC -> TAGCATAACCCTCTCTACG
GTCAAGGCGCAGCCAACTT -> TCAAGGCGCAGCCAACTTA
CGGTACTCTCTACGAACCA -> GGTACTCTCTACGAACCAG
TGTTCATGACTTCACAGAG -> GTTCATGACTTCACAGAGT
CAGGTGATAATCCCAATCT -> AGGTGATAATCCCAATCTG
ACACCTGAGGTCCTGCTCG -> CACCTGAGGTCCTGCTCGT
CGCTATTCGTCAAATGTCT -> GCTATTCGTCAAATGTCTA
TCCCGGGTACTCAAGTATG -> CCCGGGTACTCAAGTATGA
TACCGCGTAAAGCTTAATT -> ACCGCGTAAAGCTTAATTG
AAGAGGCGGTTGGATAGCG -> AGAGGCGGTTGGATAGCGT
ATAGACGCCACGACTCCCC -> TAGACGCCACGACTCCCCA
GGCGTACAGAATACCGCGT -> GCGTACAGAATACCGCGTA
CGTCAAATGTCTAGCTTCG -> GTCAAATGTCTAGCTTCGC
CCGTAGCGTGCAGGCGTAC -> CGTAGCGTGCAGGCGTACA
CGCGACCTCGATTAGAGAT -> GCGACCTCGATTAGAGATT
CGTGAAGCACGAGCCGAGA -> GTGAAGCACGAGCCGAGAC
ATAGCTGTTACCGTGGACG -> TAGCTGTTACCGTGGACGG
TACCGTGGACGGAATGCTA -> ACCGTGGACGGAATGCTAA
GTGACATTATGTCACTGGC -> TGACATTATGTCACTGGCA
GTCGGATACTCTGGAACTA -> TCGGATACTCTGGAACTAA
TGACACAGCCGTTTCGTGT -> GACACAGCCGTTTCGTGTA
GCATACCTATAACTGCGAG -> CATACCTATAACTGCGAGC
CTCGATTAGAGATTTCCGC -> TCGATTAGAGATTTCCGCT
GGGCGCATTATTGCAATGC -> GGCGCATTATTGCAATGCT
CCGTGAGCTTGTCAGGTGA -> CGTGAGCTTGTCAGGTGAT
CAGGCGCCAATATCCTCGA -> AGGCGCCAATATCCTCGAG
GGTGATAATCCCAATCTGT -> GTGATAATCCCAATCTGTG
GGACAGCGCGTAATAATGT -> GACAGCGCGTAATAATGTC
CTCCGAGACTATCACCGGT -> TCCGAGACTATCACCGGTG
AGTGACATTATGTCACTGG -> GTGACATTATGTCACTGGC
TAGCGTGCAGGCGTACAGA -> AGCGTGCAGGCGTACAGAA
CCGACTGGACCGCCATGAC -> CGACTGGACCGCCATGACA
GATAGCCGCACACCTGATC -> ATAGCCGCACACCTGATCA
TGTCCATCAGCACCGTCAT -> GTCCATCAGCACCGTCATT
AGCATGGCAGAAGCCATGT -> GCATGGCAGAAGCCATGTC
TACCAAGATATCAAGGCCT -> ACCAAGATATCAAGGCCTT
CCCGTCCCTTCTGTTAGAG -> CCGTCCCTTCTGTTAGAGC
GATGGTTACCTTCTGGACT -> ATGGTTACCTTCTGGACTT
GCCAAGATGAACATTTAAA -> CCAAGATGAACATTTAAAC
TATCCTAATGAGACCCGGC -> ATCCTAATGAGACCCGGCC
AACCAGTAGAATAGACTTG -> ACCAGTAGAATAGACTTGC
TCAGGCGCCAATATCCTCG -> CAGGCGCCAATATCCTCGA
TCAATCTACTCCTTCCCCA -> CAATCTACTCCTTCCCCAA
ACCCTCTCTACGTGTTTAA -> CCCTCTCTACGTGTTTAAG
ACTTGCTAGGAACCCTCCG -> CTTGCTAGGAACCCTCCGA
TATTGCAATGCTCTAGCAT -> ATTGCAATGCTCTAGCATA
TTGCTAGGAACCCTCCGAG -> TGCTAGGAACCCTCCGAGA
CAACTTACTCATGTGACTC -> AACTTACTCATGTGACTCT
TCACCGGTGAGTTTAATTA -> CACCGGTGAGTTTAATTAG
ATGCTCTAGCATACCTATA -> TGCTCTAGCATACCTATAA
TAAACTTTGCAATTGTTAA -> AAACTTTGCAATTGTTAAT
GAAACTACTCTGATGGTTA -> AAACTACTCTGATGGTTAC
AGCCGAGACGCTTACATGA -> GCCGAGACGCTTACATGAG
CTCCGAAGAAATCTAACAG -> TCCGAAGAAATCTAACAGA
CGGAGCACGGCTTCCGTGA -> GGAGCACGGCTTCCGTGAA
GTTAGAGCCTACAATCGGC -> TTAGAGCCTACAATCGGCT
ATCAGAACCGCCTATAGCT -> TCAGAACCGCCTATAGCTG
AAACGCCGACACTACACAT -> AACGCCGACACTACACATG
TCGACAGAGATGGTCGCGA -> CGACAGAGATGGTCGCGAT
AGTGCCCATTACAGCATGG -> GTGCCCATTACAGCATGGC
AACGGGCGCATTATTGCAA -> ACGGGCGCATTATTGCAAT
TTTACAAGATAAAATTGAC -> TTACAAGATAAAATTGACC
GGATAGCGTATGTCCATCA -> GATAGCGTATGTCCATCAG
TAGAGGACGCATGCGGATT -> AGAGGACGCATGCGGATTG
ATCAATTATTTGTTTACAA -> TCAATTATTTGTTTACAAG
GACGGAATGCTAATCAATC -> ACGGAATGCTAATCAATCA
GGAACCTCGTACTATTTTG -> GAACCTCGTACTATTTTGT
AGAGCCTACAATCGGCTCA -> GAGCCTACAATCGGCTCAC
ATCCCAATCTGTGTCTACG -> TCCCAATCTGTGTCTACGT
CGCTCACATGTAAGAGGCG -> GCTCACATGTAAGAGGCGG
AGGTACTGCTTTCTGCTAC -> GGTACTGCTTTCTGCTACG
TGCGTTACCCTGCGCTGAC -> GCGTTACCCTGCGCTGACT
CTTTCAAGGCGTCGGATAC -> TTTCAAGGCGTCGGATACT
CCATTACAGCATGGCAGAA -> CATTACAGCATGGCAGAAG
TCTCGCAAGTCCGTCTTCA -> CTCGCAAGTCCGTCTTCAG
TGCGTCCACAGGATGATTG -> GCGTCCACAGGATGATTGA
AGGCCCTTCCGCGGTTGAA -> GGCCCTTCCGCGGTTGAAC
AAGATAAAATTGACCCGAC -> AGATAAAATTGACCCGACC
GCCCGTGTATAACAGCTCT -> CCCGTGTATAACAGCTCTC
TGGACAAAACCGAGGCTCT -> GGACAAAACCGAGGCTCTC
CACAGAGTGACATTATGTC -> ACAGAGTGACATTATGTCA
TTATCTACTTATCCTAATG -> TATCTACTTATCCTAATGA
AATCACGCGGCCAAGATGA -> ATCACGCGGCCAAGATGAA
GATGGTATTCTGCTTAGGG -> ATGGTATTCTGCTTAGGGA
CAGATAGAAACTACTCTGA -> AGATAGAAACTACTCTGAT
CCTTCCCCAACCGTGTATA -> CTTCCCCAACCGTGTATAC
TGATGGTTTAAGAGAAGCG -> GATGGTTTAAGAGAAGCGT
TTGACCGATCGGGTTAGAG -> TGACCGATCGGGTTAGAGA
CTGGCAGTATCACTTCTCG -> TGGCAGTATCACTTCTCGA
CGGGCGCATTATTGCAATG -> GGGCGCATTATTGCAATGC
GTACTCGCCGTATCACCGT -> TACTCGCCGTATCACCGTG
GCTTGGGGAACCCACCGAC -> CTTGGGGAACCCACCGACG
TTAATTAGACCTGCAATCA -> TAATTAGACCTGCAATCAC
TTGGATAGCGTATGTCCAT -> TGGATAGCGTATGTCCATC
TCTGCGGAGCACGGCTTCC -> CTGCGGAGCACGGCTTCCG
CGGACTAGAGGACGCATGC -> GGACTAGAGGACGCATGCG
ACAAGATAAAATTGACCCG -> CAAGATAAAATTGACCCGA
GTTTAAGAGAAGCGTTAGA -> TTTAAGAGAAGCGTTAGAG
ATGCGGATTGTGATAGACG -> TGCGGATTGTGATAGACGC
GCATCGGCTGGACGCCTAT -> CATCGGCTGGACGCCTATA
AAACTTTGCAATTGTTAAT -> AACTTTGCAATTGTTAATG
TTTGTCTTTTAAATAGGGA -> TTGTCTTTTAAATAGGGAT
AATTGACCCGACCGACTGG -> ATTGACCCGACCGACTGGA
TGTTCGGAACAAGCTGAAA -> GTTCGGAACAAGCTGAAAC
AAATTGACCCGACCGACTG -> AATTGACCCGACCGACTGG
ACGAACCAGTAGAATAGAC -> CGAACCAGTAGAATAGACT
ACGCACCTTCTGCGGAGCA -> CGCACCTTCTGCGGAGCAC
CGGCCGAACACTTCCTGCG -> GGCCGAACACTTCCTGCGC
ATCGGCTCACTGACCTATT -> TCGGCTCACTGACCTATTT
CGCCTATACACGTGTGACC -> GCCTATACACGTGTGACCT
CGCAATTGTTGGTGTGACT -> GCAATTGTTGGTGTGACTC
ATAACAGCTCTCGATGGTA -> TAACAGCTCTCGATGGTAT
TCGGAAACGCCGACACTAC -> CGGAAACGCCGACACTACA
TCTCAGGGAGAAGGCCCAC -> CTCAGGGAGAAGGCCCACG
ATCTACTCCTTCCCCAACC -> TCTACTCCTTCCCCAACCG
GATAGCGTATGTCCATCAG -> ATAGCGTATGTCCATCAGC
TTTGCGTTAGCATAACCCT -> TTGCGTTAGCATAACCCTC
GTTTAAGCTTGCCCCGGGA -> TTTAAGCTTGCCCCGGGAC
GTAACGACCAGATAGAAAC -> TAACGACCAGATAGAAACT
CTTTCTGCGTCTGTTCATG -> TTTCTGCGTCTGTTCATGC
TGATCAAATTACTTCGGGC -> GATCAAATTACTTCGGGCT
ACCTTACCTCGCTCATGTT -> CCTTACCTCGCTCATGTTC
AAAATCGGGAAAGAACTAA -> AAATCGGGAAAGAACTAAA
GAGTCAAGGCGCAGCCAAC -> AGTCAAGGCGCAGCCAACT
TCCGCTATTCAATCCGGAC -> CCGCTATTCAATCCGGACT
ACGAGCCGAGACGCTTACA -> CGAGCCGAGACGCTTACAT
CCCCAACCGTGTATACTCA -> CCCAACCGTGTATACTCAA
CGTCGAAACTACTCTGATG -> GTCGAAACTACTCTGATGG
CCTCGAGGTACTGCTTTCT -> CTCGAGGTACTGCTTTCTG
TAGTTATACCAAGATATCA -> AGTTATACCAAGATATCAA
GTTCCCGACAACGTCTCGC -> TTCCCGACAACGTCTCGCA
CAACGTCTCGCAAGTCCGT -> AACGTCTCGCAAGTCCGTC
ATGTGCTTAGTAAAGAGAT -> TGTGCTTAGTAAAGAGATC
TTCCTGCGCCTCATGATAG -> TCCTGCGCCTCATGATAGC
CATCAGCATCTGTGTAACG -> ATCAGCATCTGTGTAACGA
CCTGATCATTTGCGTTAGC -> CTGATCATTTGCGTTAGCA
CACTTCTCGACAGAGATGG -> ACTTCTCGACAGAGATGGT
TACTCAAAGTCGGACTCGC -> ACTCAAAGTCGGACTCGCT
CTCTTACCTGATCTAGCCT -> TCTTACCTGATCTAGCCTG
CCGCTATTCTGGATGTGTC -> CGCTATTCTGGATGTGTCT
ACTAGGTACTCGCCGTATC -> CTAGGTACTCGCCGTATCA
TTCGTCAAATGTCTAGCTT -> TCGTCAAATGTCTAGCTTC
GAGTGACATTATGTCACTG -> AGTGACATTATGTCACTGG
GACAGAGATGGTCGCGATG -> ACAGAGATGGTCGCGATGT
CTATACACGTGTGACCTTA -> TATACACGTGTGACCTTAC
TGGATAGCGTATGTCCATC -> GGATAGCGTATGTCCATCA
CAATAAACCAACCGTTAAA -> AATAAACCAACCGTTAAAA
AAAGTATCGCTCACATGTA -> AAGTATCGCTCACATGTAA
GCCCCGGGACAGCGCGTAA -> CCCCGGGACAGCGCGTAAT
GGTCGCGATGTGCTTAGTA -> GTCGCGATGTGCTTAGTAA
CTTACTCATGTGACTCTTT -> TTACTCATGTGACTCTTTG
AGCGTTAGAGATTTCCGCT -> GCGTTAGAGATTTCCGCTA
CGCCAATATCCTCGAGGTA -> GCCAATATCCTCGAGGTAC
GACCACGCGCGGCTTGGGG -> ACCACGCGCGGCTTGGGGA
GGATGATTGACTAACTACC -> GATGATTGACTAACTACCG
CACAGCCGTTTCGTGTACC -> ACAGCCGTTTCGTGTACCG
CCGGGTACTCAAGTATGAC -> CGGGTACTCAAGTATGACG
ATTTAAACACTATTGGAGA -> TTTAAACACTATTGGAGAG
TTTAGTCTCACACCTGAGG -> TTAGTCTCACACCTGAGGT
TTAAACACTATTGGAGAGC -> TAAACACTATTGGAGAGCC
ATTGACTAACTACCGCCCT -> TTGACTAACTACCGCCCTT
TTATGTCACTGGCAGTATC -> TATGTCACTGGCAGTATCA
TTGAAACTCGAACATATGA -> TGAAACTCGAACATATGAA
TCCACAGGATGATTGACTA -> CCACAGGATGATTGACTAA
AGGTCATGCGAAAGTATCG -> GGTCATGCGAAAGTATCGC
CTTTGTCCTTTAGCCTTTC -> TTTGTCCTTTAGCCTTTCA
AATGCTAATCAATCAATTA -> ATGCTAATCAATCAATTAT
CGCGGTTGAACCCGGAAAA -> GCGGTTGAACCCGGAAAAG
AACTCGAACATATGAATTG -> ACTCGAACATATGAATTGA
GTCGTGCGTTACCCTGCGC -> TCGTGCGTTACCCTGCGCT
ACTCCCCAGATACAAGCGT -> CTCCCCAGATACAAGCGTC
ATTGTGATAGACGCCACGA -> TTGTGATAGACGCCACGAC
AGTATCGCTCACATGTAAG -> GTATCGCTCACATGTAAGA
TCGTGTACCGTGAGCTTGT -> CGTGTACCGTGAGCTTGTC
GTTATACCAAGATATCAAG -> TTATACCAAGATATCAAGG
ATGTAGGGTGGACTATTGG -> TGTAGGGTGGACTATTGGA
CCGATCGGGTTAGAGATTT -> CGATCGGGTTAGAGATTTC
CAGAGCATGCTCCGACCAC -> AGAGCATGCTCCGACCACG
AAGCTGAAACTACTCTGAT -> AGCTGAAACTACTCTGATG
AGCACGGCTTCCGTGAAGC -> GCACGGCTTCCGTGAAGCA
TAGCTTCGCATCTCTCAGG -> AGCTTCGCATCTCTCAGGG
GCGTGCCCTTTCGGAAACG -> CGTGCCCTTTCGGAAACGC
CTCGGTGAGTTACGCACCT -> TCGGTGAGTTACGCACCTT
CGTCTCGCAAGTCCGTCTT -> GTCTCGCAAGTCCGTCTTC
AACTAAAGCAGGCGGGCAA -> ACTAAAGCAGGCGGGCAAC
GTGTGACCTTACCTCGCTC -> TGTGACCTTACCTCGCTCA
TGTCAATAAACCAACCGTT -> GTCAATAAACCAACCGTTA
ATTGCTGGAGAGCCTCTTA -> TTGCTGGAGAGCCTCTTAC
ATTTCCGCTATTCAATCCG -> TTTCCGCTATTCAATCCGG
TGTCTGGGCTAGTCAATCT -> GTCTGGGCTAGTCAATCTA
CTGTCTGTTAAAATGACTG -> TGTCTGTTAAAATGACTGC
CCTTACCTCGCTCATGTTC -> CTTACCTCGCTCATGTTCG
GTTTGTCTTTTAAATAGGG -> TTTGTCTTTTAAATAGGGA
CTAGCATACCTATAACTGC -> TAGCATACCTATAACTGCG
GAGAAGGCCCACGATCTAT -> AGAAGGCCCACGATCTATT
TGTGTCTACGTCTACCATG -> GTGTCTACGTCTACCATGT
CGCAGCCAACTTACTCATG -> GCAGCCAACTTACTCATGT
CTCGACAGAGATGGTCGCG -> TCGACAGAGATGGTCGCGA
ATTGAAACTCGAACATATG -> TTGAAACTCGAACATATGA
TGTCGCAATTGTTGGTGTG -> GTCGCAATTGTTGGTGTGA
TTGGTGTGACTCCGAAGAA -> TGGTGTGACTCCGAAGAAA
GGACAAAACCGAGGCTCTC -> GACAAAACCGAGGCTCTCA
GATGGTCGCGATGTGCTTA -> ATGGTCGCGATGTGCTTAG
GAAGCGTTAGAGATTTCCG -> AAGCGTTAGAGATTTCCGC
CTATAACTGCGAGCAAGGT -> TATAACTGCGAGCAAGGTC
CAGGTATCTGCTCAAATGT -> AGGTATCTGCTCAAATGTT
CATTTATGTAGGCGGTCCC -> ATTTATGTAGGCGGTCCCG
AGGATGATTGACTAACTAC -> GGATGATTGACTAACTACC
AACAATTTATCTACTTATC -> ACAATTTATCTACTTATCC
CCAACCGTGTATACTCAAA -> CAACCGTGTATACTCAAAG
AACAAGCTGAAACTACTCT -> ACAAGCTGAAACTACTCTG
GCTCACATGTAAGAGGCGG -> CTCACATGTAAGAGGCGGT
GGGCAACAATTTATCTACT -> GGCAACAATTTATCTACTT
CTAGGTACTCGCCGTATCA -> TAGGTACTCGCCGTATCAC
CCATGTTCATGACTTCACA -> CATGTTCATGACTTCACAG
GCCAATATCCTCGAGGTAC -> CCAATATCCTCGAGGTACT
TCCGCGGTTGAACCCGGAA -> CCGCGGTTGAACCCGGAAA
ACCCTCCGAGACTATCACC -> CCCTCCGAGACTATCACCG
ATGAGGTCATGCGAAAGTA -> TGAGGTCATGCGAAAGTAT
CGTAAAGCTTAATTGCTGG -> GTAAAGCTTAATTGCTGGA
TCCTCGAGGTACTGCTTTC -> CCTCGAGGTACTGCTTTCT
TTTAAGCTTGCCCCGGGAC -> TTAAGCTTGCCCCGGGACA
TCGGGAAAGAACTAAAGCA -> CGGGAAAGAACTAAAGCAG
CCTATACACGTGTGACCTT -> CTATACACGTGTGACCTTA
AGTAGAATAGACTTGCTAG -> GTAGAATAGACTTGCTAGG
ACTCTGATGGTTACCTTCT -> CTCTGATGGTTACCTTCTG
TGAGGTCCTGCTCGTATCA -> GAGGTCCTGCTCGTATCAG
GACGCTTACATGAGGTCAT -> ACGCTTACATGAGGTCATG
TTTGGCCCGTGTATAACAG -> TTGGCCCGTGTATAACAGC
ACTATTGGAATCAGAACCG -> CTATTGGAATCAGAACCGC
AGCCAACTTACTCATGTGA -> GCCAACTTACTCATGTGAC
CCTTCTGGACTTAGAGATT -> CTTCTGGACTTAGAGATTT
TCGACTCAGGTATCTGCTC -> CGACTCAGGTATCTGCTCA
AATAAACCAACCGTTAAAA -> ATAAACCAACCGTTAAAAT
GCCTATAGCTGTTACCGTG -> CCTATAGCTGTTACCGTGG
GTTAGCATAACCCTCTCTA -> TTAGCATAACCCTCTCTAC
ATTAGACCTGCAATCACGC -> TTAGACCTGCAATCACGCG
CACGACTCCCCAGATACAA -> ACGACTCCCCAGATACAAG
CCGTCATTTAAACACTATT -> CGTCATTTAAACACTATTG
TGACCTTACCTCGCTCATG -> GACCTTACCTCGCTCATGT
TCGTCAAATGTCTAGCTTC -> CGTCAAATGTCTAGCTTCG
CCCGGAAAAGCCGTAGCGT -> CCGGAAAAGCCGTAGCGTG
GAACCGCCTATAGCTGTTA -> AACCGCCTATAGCTGTTAC
CTGAAACTACTCTGATGGT -> TGAAACTACTCTGATGGTT
GTCGAAACTACTCTGATGG -> TCGAAACTACTCTGATGGT
TGACCGATCGGGTTAGAGA -> GACCGATCGGGTTAGAGAT
ACGGCTCGGTGAGTTACGC -> CGGCTCGGTGAGTTACGCA
CGACCGACTGGACCGCCAT -> GACCGACTGGACCGCCATG
GATGGTTGACCGATCGGGT -> ATGGTTGACCGATCGGGTT
TATTCTGCTTAGGGAAGGC -> ATTCTGCTTAGGGAAGGCC
CTCTGATGGTTTAAGAGAA -> TCTGATGGTTTAAGAGAAG
GCCGTTTCGTGTACCGTGA -> CCGTTTCGTGTACCGTGAG
TCTTACCTGATCTAGCCTG -> CTTACCTGATCTAGCCTGA
ACTCTGATGGTTTAAGAGA -> CTCTGATGGTTTAAGAGAA
CGCGGCCAAGATGAACATT -> GCGGCCAAGATGAACATTT
CTTCCGCGGTTGAACCCGG -> TTCCGCGGTTGAACCCGGA
ATACTCTGGAACTAATTCT -> TACTCTGGAACTAATTCTT
ACACTACACATGTAGGGTG -> CACTACACATGTAGGGTGG
TAACGACCAGATAGAAACT -> AACGACCAGATAGAAACTA
CAAGGCGCAGCCAACTTAC -> AAGGCGCAGCCAACTTACT
AAAGAACTAAAGCAGGCGG -> AAGAACTAAAGCAGGCGGG
CCCTTCCGCGGTTGAACCC -> CCTTCCGCGGTTGAACCCG
TTCCCGACAACGTCTCGCA -> TCCCGACAACGTCTCGCAA
CAATTGTTAATGGAAAGTA -> AATTGTTAATGGAAAGTAC
TATTGTTCATTTATGTAGG -> ATTGTTCATTTATGTAGGC
AATTATTTGTTTACAAGAT -> ATTATTTGTTTACAAGATA
TTGCGTTAGCATAACCCTC -> TGCGTTAGCATAACCCTCT
ACCTATTTCTTTACTGTCT -> CCTATTTCTTTACTGTCTG
GAGATTTCCGCTATTCGTC -> AGATTTCCGCTATTCGTCA
CAGTAGAATAGACTTGCTA -> AGTAGAATAGACTTGCTAG
TGCAGGCGTACAGAATACC -> GCAGGCGTACAGAATACCG
TTCCCCAACCGTGTATACT -> TCCCCAACCGTGTATACTC
GGCCCTTCCGCGGTTGAAC -> GCCCTTCCGCGGTTGAACC
GACTATTGGAATCAGAACC -> ACTATTGGAATCAGAACCG
CCACGCGCGGCTTGGGGAA -> CACGCGCGGCTTGGGGAAC
CGCTATTCAATCCGGACTA -> GCTATTCAATCCGGACTAG
TCTTGACCTTTGGCCCGTG -> CTTGACCTTTGGCCCGTGT
GTCCTGCTCGTATCAGTGC -> TCCTGCTCGTATCAGTGCG
TGTATAACAGCTCTCGATG -> GTATAACAGCTCTCGATGG
TGAGACCCGGCCGAACACT -> GAGACCCGGCCGAACACTT
TCGTACTATTTTGTCAATA -> CGTACTATTTTGTCAATAA
TAAAATCGGGAAAGAACTA -> AAAATCGGGAAAGAACTAA
TTAGTCTCACACCTGAGGT -> TAGTCTCACACCTGAGGTC
TCGATGGTATTCTGCTTAG -> CGATGGTATTCTGCTTAGG
TCCGAGACTATCACCGGTG -> CCGAGACTATCACCGGTGA
TTACTGTCTGTTAAAATGA -> TACTGTCTGTTAAAATGAC
CAGCATGGCAGAAGCCATG -> AGCATGGCAGAAGCCATGT
CTCTACGTGTTTAAGCTTG -> TCTACGTGTTTAAGCTTGC
CCTTTGGCCCGTGTATAAC -> CTTTGGCCCGTGTATAACA
GCGCAGCCAACTTACTCAT -> CGCAGCCAACTTACTCATG
CACGCATCGGCTGGACGCC -> ACGCATCGGCTGGACGCCT
CTAGCCTGATCAAATTACT -> TAGCCTGATCAAATTACTT
TTCTGCGGAGCACGGCTTC -> TCTGCGGAGCACGGCTTCC
AAGAGAAGCGTTAGAGATT -> AGAGAAGCGTTAGAGATTT
TACGTCTACCATGTTCATG -> ACGTCTACCATGTTCATGA
TAGGCGGTCCCGGGTACTC -> AGGCGGTCCCGGGTACTCA
AAGAACTAAAGCAGGCGGG -> AGAACTAAAGCAGGCGGGC
AGAGATGGTCGCGATGTGC -> GAGATGGTCGCGATGTGCT
CTGTTCATGCATCAGCATC -> TGTTCATGCATCAGCATCT
TCTATTGTTCATTTATGTA -> CTATTGTTCATTTATGTAG
AATATCCTCGAGGTACTGC -> ATATCCTCGAGGTACTGCT
GGTTTAAGAGAAGCGTTAG -> GTTTAAGAGAAGCGTTAGA
CTAATCAATCAATTATTTG -> TAATCAATCAATTATTTGT
AGGCGTCGGATACTCTGGA -> GGCGTCGGATACTCTGGAA
GAAACTACTCTGATGGTTC -> AAACTACTCTGATGGTTCG
ACAAGCTGAAACTACTCTG -> CAAGCTGAAACTACTCTGA
TGATAGCCGCACACCTGAT -> GATAGCCGCACACCTGATC
CGAGCCGAGACGCTTACAT -> GAGCCGAGACGCTTACATG
ACCACGCGCGGCTTGGGGA -> CCACGCGCGGCTTGGGGAA
TTGAACCCGGAAAAGCCGT -> TGAACCCGGAAAAGCCGTA
ACAAGCGTCCTCAAGTGCC -> CAAGCGTCCTCAAGTGCCC
ACACTATTGGAGAGCCGAC -> CACTATTGGAGAGCCGACG
TTCCGTGAAGCACGAGCCG -> TCCGTGAAGCACGAGCCGA
ATAATCCCAATCTGTGTCT -> TAATCCCAATCTGTGTCTA
GGGAGTCAAGGCGCAGCCA -> GGAGTCAAGGCGCAGCCAA
CGGCTCGGTGAGTTACGCA -> GGCTCGGTGAGTTACGCAC
AAGCAGGCGGGCAACAATT -> AGCAGGCGGGCAACAATTT
GACAACGTCTCGCAAGTCC -> ACAACGTCTCGCAAGTCCG
GCTCATGTTCGGAACAAGC -> CTCATGTTCGGAACAAGCT
TTTCAAGGCGTCGGATACT -> TTCAAGGCGTCGGATACTC
TTCCGCTATTCTGGATGTG -> TCCGCTATTCTGGATGTGT
GCGAGCAAGGTCAGCCCGT -> CGAGCAAGGTCAGCCCGTC
TGCGGTACTCTCTACGAAC -> GCGGTACTCTCTACGAACC
TAGTCAATCTACTCCTTCC -> AGTCAATCTACTCCTTCCC
GGCAGTATCACTTCTCGAC -> GCAGTATCACTTCTCGACA
AAGTGCCCATTACAGCATG -> AGTGCCCATTACAGCATGG
ATGGTCGCGATGTGCTTAG -> TGGTCGCGATGTGCTTAGT
TCCGTCTTCAGGCGCCAAT -> CCGTCTTCAGGCGCCAATA
TAATTGCTGGAGAGCCTCT -> AATTGCTGGAGAGCCTCTT
CCCTTTCGGAAACGCCGAC -> CCTTTCGGAAACGCCGACA
AGATTTCCGCTATTCAATC -> GATTTCCGCTATTCAATCC
CGTTACCCTGCGCTGACTT -> GTTACCCTGCGCTGACTTG
TGGCAGAAGCCATGTCTGG -> GGCAGAAGCCATGTCTGGG
CACGCGGCCAAGATGAACA -> ACGCGGCCAAGATGAACAT
TCGCAAGTCCGTCTTCAGG -> CGCAAGTCCGTCTTCAGGC
AATTAGACCTGCAATCACG -> ATTAGACCTGCAATCACGC
CCGCCTATAGCTGTTACCG -> CGCCTATAGCTGTTACCGT
GGACTCGCTAACCATTGAA -> GACTCGCTAACCATTGAAA
CGGGACAGCGCGTAATAAT -> GGGACAGCGCGTAATAATG
TTACATGAGGTCATGCGAA -> TACATGAGGTCATGCGAAA
ACTCTGATGGTTCGCGACC -> CTCTGATGGTTCGCGACCT
TCTCGATGGTATTCTGCTT -> CTCGATGGTATTCTGCTTA
TGAGCTTGTCAGGTGATAA -> GAGCTTGTCAGGTGATAAT
ACTCGCCGTATCACCGTGC -> CTCGCCGTATCACCGTGCG
AACCATTGAAACTCGAACA -> ACCATTGAAACTCGAACAT
CTTCAGGCGCCAATATCCT -> TTCAGGCGCCAATATCCTC
GTGTATACTCAAAGTCGGA -> TGTATACTCAAAGTCGGAC
AGCATGCTCCGACCACGCG -> GCATGCTCCGACCACGCGC
ATAGGGATTTTATGCCTGT -> TAGGGATTTTATGCCTGTC
TCACATGTAAGAGGCGGTT -> CACATGTAAGAGGCGGTTG
AGTCTCACACCTGAGGTCC -> GTCTCACACCTGAGGTCCT
TTCGTGTACCGTGAGCTTG -> TCGTGTACCGTGAGCTTGT
CGCCTATAGCTGTTACCGT -> GCCTATAGCTGTTACCGTG
GTCTCACACCTGAGGTCCT -> TCTCACACCTGAGGTCCTG
GCTAATCAATCAATTATTT -> CTAATCAATCAATTATTTG
GCGGTTGAACCCGGAAAAG -> CGGTTGAACCCGGAAAAGC
TAGACCTGCAATCACGCGG -> AGACCTGCAATCACGCGGC
CGTAATAATGTCGCAATTG -> GTAATAATGTCGCAATTGT
CCAACTTACTCATGTGACT -> CAACTTACTCATGTGACTC
CGAAACTACTCTGATGGTT -> GAAACTACTCTGATGGTTC
TGCGCCTCATGATAGCCGC -> GCGCCTCATGATAGCCGCA
GTTTACAAGATAAAATTGA -> TTTACAAGATAAAATTGAC
CAGAGATGGTCGCGATGTG -> AGAGATGGTCGCGATGTGC
GTATCTGCTCAAATGTTTG -> TATCTGCTCAAATGTTTGT
GCGTCCTCAAGTGCCCATT -> CGTCCTCAAGTGCCCATTA
TTAGGGAAGGCCCTTCCGC -> TAGGGAAGGCCCTTCCGCG
CGTCTGTTCATGCATCAGC -> GTCTGTTCATGCATCAGCA
GCAATTGTTGGTGTGACTC -> CAATTGTTGGTGTGACTCC
CTGTCGTGCGTTACCCTGC -> TGTCGTGCGTTACCCTGCG
CTTCTGTTAGAGCCTACAA -> TTCTGTTAGAGCCTACAAT
CTGCGGAGCACGGCTTCCG -> TGCGGAGCACGGCTTCCGT
AGGCGGTTGGATAGCGTAT -> GGCGGTTGGATAGCGTATG
AGCGTGCAGGCGTACAGAA -> GCGTGCAGGCGTACAGAAT
GGAACAAGCTGAAACTACT -> GAACAAGCTGAAACTACTC
TGGAACCTCGTACTATTTT -> GGAACCTCGTACTATTTTG
TTTGCAATTGTTAATGGAA -> TTGCAATTGTTAATGGAAA
GAACAAGCTGAAACTACTC -> AACAAGCTGAAACTACTCT
CTTTAGCCTTTCAAGGCGT -> TTTAGCCTTTCAAGGCGTC
CTTTAGTCTCACACCTGAG -> TTTAGTCTCACACCTGAGG
GCACACCTGATCATTTGCG -> CACACCTGATCATTTGCGT
TGTGTAACGACCAGATAGA -> GTGTAACGACCAGATAGAA
TGCTAATCAATCAATTATT -> GCTAATCAATCAATTATTT
ACGGCTTCCGTGAAGCACG -> CGGCTTCCGTGAAGCACGA
GACTAGAGGACGCATGCGG -> ACTAGAGGACGCATGCGGA
TCTGCTCAAATGTTTGTCT -> CTGCTCAAATGTTTGTCTT
TCTTCAGGCGCCAATATCC -> CTTCAGGCGCCAATATCCT
TACAATCGGCTCACTGACC -> ACAATCGGCTCACTGACCT
TCGATTAGAGATTTCCGCT -> CGATTAGAGATTTCCGCTA
CAGTATCACTTCTCGACAG -> AGTATCACTTCTCGACAGA
TTACTTCGGGCTAGTTATA -> TACTTCGGGCTAGTTATAC
TAAAATGACTGCGGTACTC -> AAAATGACTGCGGTACTCT
TATTTCTTTACTGTCTGTT -> ATTTCTTTACTGTCTGTTA
TATCTGCTCAAATGTTTGT -> ATCTGCTCAAATGTTTGTC
TCAAATGTCTAGCTTCGCA -> CAAATGTCTAGCTTCGCAT
ACTTCCTGCGCCTCATGAT -> CTTCCTGCGCCTCATGATA
ATACAAGCGTCCTCAAGTG -> TACAAGCGTCCTCAAGTGC
CGCACACCTGATCATTTGC -> GCACACCTGATCATTTGCG
AGGTGATAATCCCAATCTG -> GGTGATAATCCCAATCTGT
CGGCTTGGGGAACCCACCG -> GGCTTGGGGAACCCACCGA
GCTAAGGATTCTTGACCTT -> CTAAGGATTCTTGACCTTT
AGAGATTTCCGCTATTCAA -> GAGATTTCCGCTATTCAAT
ATCACCGGTGAGTTTAATT -> TCACCGGTGAGTTTAATTA
CATGTAGGGTGGACTATTG -> ATGTAGGGTGGACTATTGG
TACGGAACGGGCGCATTAT -> ACGGAACGGGCGCATTATT
TTTAAACTTTGCAATTGTT -> TTAAACTTTGCAATTGTTA
TCAAGGCGCAGCCAACTTA -> CAAGGCGCAGCCAACTTAC
AGAGATTTCCGCTATTCAC -> GAGATTTCCGCTATTCACG
GGTACTCAAGTATGACGAA -> GTACTCAAGTATGACGAAA
CTGCGAGCAAGGTCAGCCC -> TGCGAGCAAGGTCAGCCCG
TCGTATCAGTGCGTGCCCT -> CGTATCAGTGCGTGCCCTT
CGGCTGGACGCCTATACAC -> GGCTGGACGCCTATACACG
ACGATCTATTGTTCATTTA -> CGATCTATTGTTCATTTAT
CCGACAACGTCTCGCAAGT -> CGACAACGTCTCGCAAGTC
CGTGGACGGAATGCTAATC -> GTGGACGGAATGCTAATCA
TCTCGACTCAGGTATCTGC -> CTCGACTCAGGTATCTGCT
CTCCCCAGATACAAGCGTC -> TCCCCAGATACAAGCGTCC
GTCCCGGGTACTCAAGTAT -> TCCCGGGTACTCAAGTATG
TCGGATACTCTGGAACTAA -> CGGATACTCTGGAACTAAT
ACCGCCTATAGCTGTTACC -> CCGCCTATAGCTGTTACCG
GATTGACTAACTACCGCCC -> ATTGACTAACTACCGCCCT
TTATACCAAGATATCAAGG -> TATACCAAGATATCAAGGC
CAATTGTTGGTGTGACTCC -> AATTGTTGGTGTGACTCCG
TCGGAACAAGCTGAAACTA -> CGGAACAAGCTGAAACTAC
GTATGTCCATCAGCACCGT -> TATGTCCATCAGCACCGTC
TTTCTCAGCTTGGACAAAA -> TTCTCAGCTTGGACAAAAC
TAGAGATTTCCGCTATTCG -> AGAGATTTCCGCTATTCGT
TTGTCTTTTAAATAGGGAT -> TGTCTTTTAAATAGGGATT
TCGAACATATGAATTGAAA -> CGAACATATGAATTGAAAA
ATCGGCTGGACGCCTATAC -> TCGGCTGGACGCCTATACA
TGACATTATGTCACTGGCA -> GACATTATGTCACTGGCAG
GAGGCTCTCAGTACTAGGT -> AGGCTCTCAGTACTAGGTA
TCCTGCTCGTATCAGTGCG -> CCTGCTCGTATCAGTGCGT
TAACCCTCTCTACGTGTTT -> AACCCTCTCTACGTGTTTA
AAACTACTCTGATGGTTAC -> AACTACTCTGATGGTTACC
TATACACGTGTGACCTTAC -> ATACACGTGTGACCTTACC
ACACATGTAGGGTGGACTA -> CACATGTAGGGTGGACTAT
TGGTTGACCGATCGGGTTA -> GGTTGACCGATCGGGTTAG
CGTCCTCAAGTGCCCATTA -> GTCCTCAAGTGCCCATTAC
CTCTGATGGTTCGCGACCT -> TCTGATGGTTCGCGACCTC
CGGGAAAGAACTAAAGCAG -> GGGAAAGAACTAAAGCAGG
CTGCGCTGACTTGAGAAGG -> TGCGCTGACTTGAGAAGGC
ACTACTCTGATGGTTACCT -> CTACTCTGATGGTTACCTT
AACTACTCTGATGGTTGAC -> ACTACTCTGATGGTTGACC
GACGCCTATACACGTGTGA -> ACGCCTATACACGTGTGAC
GTAAAGAGATCTGGAACCT -> TAAAGAGATCTGGAACCTC
TGCTACGGAACGGGCGCAT -> GCTACGGAACGGGCGCATT
AGGGAGAAGGCCCACGATC -> GGGAGAAGGCCCACGATCT
TTATTGCAATGCTCTAGCA -> TATTGCAATGCTCTAGCAT
TCACGCGGCCAAGATGAAC -> CACGCGGCCAAGATGAACA
CGTGGGAGTCAAGGCGCAG -> GTGGGAGTCAAGGCGCAGC
CAGAACCGCCTATAGCTGT -> AGAACCGCCTATAGCTGTT
GGCTCGGTGAGTTACGCAC -> GCTCGGTGAGTTACGCACC
GCTTAGGGAAGGCCCTTCC -> CTTAGGGAAGGCCCTTCCG
GGCCCGTGTATAACAGCTC -> GCCCGTGTATAACAGCTCT
AGTCCGTCTTCAGGCGCCA -> GTCCGTCTTCAGGCGCCAA
AGCTGAAACTACTCTGATG -> GCTGAAACTACTCTGATGG
AACCCTCCGAGACTATCAC -> ACCCTCCGAGACTATCACC
CATGACTTCACAGAGTGAC -> ATGACTTCACAGAGTGACA
TTCATTTATGTAGGCGGTC -> TCATTTATGTAGGCGGTCC
CGATGTGCTTAGTAAAGAG -> GATGTGCTTAGTAAAGAGA
AAGTCGTGGGAGTCAAGGC -> AGTCGTGGGAGTCAAGGCG
ATCGGGTTAGAGATTTCCG -> TCGGGTTAGAGATTTCCGC
GGAGTCAAGGCGCAGCCAA -> GAGTCAAGGCGCAGCCAAC
GTCTAGCTTCGCATCTCTC -> TCTAGCTTCGCATCTCTCA
TACAAGCGTCCTCAAGTGC -> ACAAGCGTCCTCAAGTGCC
ATTCACGGCTCGGTGAGTT -> TTCACGGCTCGGTGAGTTA
AGCCTACAATCGGCTCACT -> GCCTACAATCGGCTCACTG
CTTCACAGAGTGACATTAT -> TTCACAGAGTGACATTATG
CGAGACTATCACCGGTGAG -> GAGACTATCACCGGTGAGT
CAAGATAAAATTGACCCGA -> AAGATAAAATTGACCCGAC
CGGCTCACTGACCTATTTC -> GGCTCACTGACCTATTTCT
CAAAGTCGGACTCGCTAAC -> AAAGTCGGACTCGCTAACC
CGCAAGTCCGTCTTCAGGC -> GCAAGTCCGTCTTCAGGCG
CTGTTACCGTGGACGGAAT -> TGTTACCGTGGACGGAATG
TGTCTCGACTCAGGTATCT -> GTCTCGACTCAGGTATCTG
CTGCGTCTGTTCATGCATC -> TGCGTCTGTTCATGCATCA
CTACACATGTAGGGTGGAC -> TACACATGTAGGGTGGACT
TGTCCTTTAGCCTTTCAAG -> GTCCTTTAGCCTTTCAAGG
GACCGATCGGGTTAGAGAT -> ACCGATCGGGTTAGAGATT
GTCGTGGGAGTCAAGGCGC -> TCGTGGGAGTCAAGGCGCA
GTAGCGTGCAGGCGTACAG -> TAGCGTGCAGGCGTACAGA
AAATAGGGATTTTATGCCT -> AATAGGGATTTTATGCCTG
CTGATCTAGCCTGATCAAA -> TGATCTAGCCTGATCAAAT
CTCGCCGTATCACCGTGCG -> TCGCCGTATCACCGTGCGT
GTACTCTCTACGAACCAGT -> TACTCTCTACGAACCAGTA
ACCATTGAAACTCGAACAT -> CCATTGAAACTCGAACATA
GCCCACGATCTATTGTTCA -> CCCACGATCTATTGTTCAT
CTTTACTGTCTGTTAAAAT -> TTTACTGTCTGTTAAAATG
TCAAGTATGACGAAATGCT -> CAAGTATGACGAAATGCTC
TCATGTTCGGAACAAGCTG -> CATGTTCGGAACAAGCTGA
TACTCTGATGGTTTAAGAG -> ACTCTGATGGTTTAAGAGA
CTATTTCTTTACTGTCTGT -> TATTTCTTTACTGTCTGTT
CAAGATATCAAGGCCTTTA -> AAGATATCAAGGCCTTTAG
CTACGGAACGGGCGCATTA -> TACGGAACGGGCGCATTAT
ATGCATCAGCATCTGTGTA -> TGCATCAGCATCTGTGTAA
CTGTGACACGCATCGGCTG -> TGTGACACGCATCGGCTGG
CGAAAGTATCGCTCACATG -> GAAAGTATCGCTCACATGT
CGTACAGAATACCGCGTAA -> GTACAGAATACCGCGTAAA
CCTGCTCGTATCAGTGCGT -> CTGCTCGTATCAGTGCGTG
CTCGCTAACCATTGAAACT -> TCGCTAACCATTGAAACTC
ATGTCCATCAGCACCGTCA -> TGTCCATCAGCACCGTCAT
AAGCCATGTCTGGGCTAGT -> AGCCATGTCTGGGCTAGTC
CGACCTCGATTAGAGATTT -> GACCTCGATTAGAGATTTC
CGTGTGACCTTACCTCGCT -> GTGTGACCTTACCTCGCTC
GGCGCATTATTGCAATGCT -> GCGCATTATTGCAATGCTC
TTCTTTACTGTCTGTTAAA -> TCTTTACTGTCTGTTAAAA
ACCTTCTGCGGAGCACGGC -> CCTTCTGCGGAGCACGGCT
TGGGCTAGTCAATCTACTC -> GGGCTAGTCAATCTACTCC
GATGATTGACTAACTACCG -> ATGATTGACTAACTACCGC
CCGCACACCTGATCATTTG -> CGCACACCTGATCATTTGC
AGACCCGGCCGAACACTTC -> GACCCGGCCGAACACTTCC
AAGCGTTAGAGATTTCCGC -> AGCGTTAGAGATTTCCGCT
CGTACTATTTTGTCAATAA -> GTACTATTTTGTCAATAAA
TCTGGAACTAATTCTTTCT -> CTGGAACTAATTCTTTCTG
AACCCTCTCTACGTGTTTA -> ACCCTCTCTACGTGTTTAA
TCATGTGACTCTTTGTCCT -> CATGTGACTCTTTGTCCTT
CCCTGTGACACGCATCGGC -> CCTGTGACACGCATCGGCT
TACGAACCAGTAGAATAGA -> ACGAACCAGTAGAATAGAC
CCTCTCTACGTGTTTAAGC -> CTCTCTACGTGTTTAAGCT
ATTAGAGATTTCCGCTATT -> TTAGAGATTTCCGCTATTC
AACATATGAATTGAAAAGT -> ACATATGAATTGAAAAGTC
GTCTTTTAAATAGGGATTT -> TCTTTTAAATAGGGATTTT
CTCAGGTATCTGCTCAAAT -> TCAGGTATCTGCTCAAATG
AGACTATCACCGGTGAGTT -> GACTATCACCGGTGAGTTT
TCTACGTGTTTAAGCTTGC -> CTACGTGTTTAAGCTTGCC
ACATGAGGTCATGCGAAAG -> CATGAGGTCATGCGAAAGT
CCTGCAATCACGCGGCCAA -> CTGCAATCACGCGGCCAAG
ATGGCAGAAGCCATGTCTG -> TGGCAGAAGCCATGTCTGG
GAGCCTACAATCGGCTCAC -> AGCCTACAATCGGCTCACT
CGGACTCGCTAACCATTGA -> GGACTCGCTAACCATTGAA
TATGACGAAATGCTCGAGG -> ATGACGAAATGCTCGAGGG
AAGTATCGCTCACATGTAA -> AGTATCGCTCACATGTAAG
TCTACGAACCAGTAGAATA -> CTACGAACCAGTAGAATAG
ACTGGCAGTATCACTTCTC -> CTGGCAGTATCACTTCTCG
TGGATGTGTCTCGACTCAG -> GGATGTGTCTCGACTCAGG
GCGTCTGTTCATGCATCAG -> CGTCTGTTCATGCATCAGC
AGATTTCCGCTATTCTGGA -> GATTTCCGCTATTCTGGAT
AGCCGTAGCGTGCAGGCGT -> GCCGTAGCGTGCAGGCGTA
CGTGTATACTCAAAGTCGG -> GTGTATACTCAAAGTCGGA
TTAATGGAAAGTACCCCTG -> TAATGGAAAGTACCCCTGT
CACCGGTGAGTTTAATTAG -> ACCGGTGAGTTTAATTAGA
GAAGGCCCTTCCGCGGTTG -> AAGGCCCTTCCGCGGTTGA
ATTTCTTTACTGTCTGTTA -> TTTCTTTACTGTCTGTTAA
TGACTGCGGTACTCTCTAC -> GACTGCGGTACTCTCTACG
AATGTCTAGCTTCGCATCT -> ATGTCTAGCTTCGCATCTC
TCTCTACGAACCAGTAGAA -> CTCTACGAACCAGTAGAAT
ATTCTTTCTGCGTCTGTTC -> TTCTTTCTGCGTCTGTTCA
TACTCAAGTATGACGAAAT -> ACTCAAGTATGACGAAATG
TAAATAGGGATTTTATGCC -> AAATAGGGATTTTATGCCT
AGCATACCTATAACTGCGA -> GCATACCTATAACTGCGAG
GTCGCGATGTGCTTAGTAA -> TCGCGATGTGCTTAGTAAA
TTCCGCTATTCGTCAAATG -> TCCGCTATTCGTCAAATGT
GCAGAAGCCATGTCTGGGC -> CAGAAGCCATGTCTGGGCT
ACAGCGCGTAATAATGTCG -> CAGCGCGTAATAATGTCGC
TACCGCCCTTGTTCCCGAC -> ACCGCCCTTGTTCCCGACA
GATAGACGCCACGACTCCC -> ATAGACGCCACGACTCCCC
GAGCTTGTCAGGTGATAAT -> AGCTTGTCAGGTGATAATC
ATGTCACTGGCAGTATCAC -> TGTCACTGGCAGTATCACT
AGGCGGGCAACAATTTATC -> GGCGGGCAACAATTTATCT
GAACTAATTCTTTCTGCGT -> AACTAATTCTTTCTGCGTC
ACTGACCTATTTCTTTACT -> CTGACCTATTTCTTTACTG
TCGAGGGACGGTAAGCTAT -> CGAGGGACGGTAAGCTATT
AATCCCAATCTGTGTCTAC -> ATCCCAATCTGTGTCTACG
CTACTTATCCTAATGAGAC -> TACTTATCCTAATGAGACC
CCCTCTCTACGTGTTTAAG -> CCTCTCTACGTGTTTAAGC
CCAACCGTTAAAATCGGGA -> CAACCGTTAAAATCGGGAA
CACATGTAGGGTGGACTAT -> ACATGTAGGGTGGACTATT
AAATGTTTGTCTTTTAAAT -> AATGTTTGTCTTTTAAATA
CACAGGATGATTGACTAAC -> ACAGGATGATTGACTAACT
CTTGGACAAAACCGAGGCT -> TTGGACAAAACCGAGGCTC
TGTGACCTTACCTCGCTCA -> GTGACCTTACCTCGCTCAT
AGATAAAATTGACCCGACC -> GATAAAATTGACCCGACCG
GTGGACGGAATGCTAATCA -> TGGACGGAATGCTAATCAA
CTGATCAAATTACTTCGGG -> TGATCAAATTACTTCGGGC
GGTACTCTCTACGAACCAG -> GTACTCTCTACGAACCAGT
ATCATTTGCGTTAGCATAA -> TCATTTGCGTTAGCATAAC
TAATGGAAAGTACCCCTGT -> AATGGAAAGTACCCCTGTG
ATACCTATAACTGCGAGCA -> TACCTATAACTGCGAGCAA
TCATTTGCGTTAGCATAAC -> CATTTGCGTTAGCATAACC
GCTTAATTGCTGGAGAGCC -> CTTAATTGCTGGAGAGCCT
AAAATGACTGCGGTACTCT -> AAATGACTGCGGTACTCTC
GGACTATTGGAATCAGAAC -> GACTATTGGAATCAGAACC
GTCCACAGGATGATTGACT -> TCCACAGGATGATTGACTA
ACTCAGGTATCTGCTCAAA -> CTCAGGTATCTGCTCAAAT
TAAAGCAGGCGGGCAACAA -> AAAGCAGGCGGGCAACAAT
TAAGGATTCTTGACCTTTG -> AAGGATTCTTGACCTTTGG
TTGAAAAGTCGTGGGAGTC -> TGAAAAGTCGTGGGAGTCA
GTTGGTGTGACTCCGAAGA -> TTGGTGTGACTCCGAAGAA
CTGGAGAGCCTCTTACCTG -> TGGAGAGCCTCTTACCTGA
TGTAGGCGGTCCCGGGTAC -> GTAGGCGGTCCCGGGTACT
GACGCCACGACTCCCCAGA -> ACGCCACGACTCCCCAGAT
GCCCGTCCCTTCTGTTAGA -> CCCGTCCCTTCTGTTAGAG
TTTATGTAGGCGGTCCCGG -> TTATGTAGGCGGTCCCGGG
TGTCAGGTGATAATCCCAA -> GTCAGGTGATAATCCCAAT
GCTATTCGTCAAATGTCTA -> CTATTCGTCAAATGTCTAG
CTCAAGTATGACGAAATGC -> TCAAGTATGACGAAATGCT
ATGCTCCGACCACGCGCGG -> TGCTCCGACCACGCGCGGC
AGAGATTTCCGCTATTCTG -> GAGATTTCCGCTATTCTGG
AGAAGCGTTAGAGATTTCC -> GAAGCGTTAGAGATTTCCG
TGCGAGCAAGGTCAGCCCG -> GCGAGCAAGGTCAGCCCGT
ACCTCGTACTATTTTGTCA -> CCTCGTACTATTTTGTCAA
TCCCAATCTGTGTCTACGT -> CCCAATCTGTGTCTACGTC
TGTCTACGTCTACCATGTT -> GTCTACGTCTACCATGTTC
GAAACTACTCTGATGGTTG -> AAACTACTCTGATGGTTGA
CACTGACCTATTTCTTTAC -> ACTGACCTATTTCTTTACT
TTCACAGAGTGACATTATG -> TCACAGAGTGACATTATGT
GCGCCTCATGATAGCCGCA -> CGCCTCATGATAGCCGCAC
ACAGAGCATGCTCCGACCA -> CAGAGCATGCTCCGACCAC
TCAGGTGATAATCCCAATC -> CAGGTGATAATCCCAATCT
GGAACGGGCGCATTATTGC -> GAACGGGCGCATTATTGCA
TTGTTCCCGACAACGTCTC -> TGTTCCCGACAACGTCTCG
TACCTTCTGGACTTAGAGA -> ACCTTCTGGACTTAGAGAT
CAAGGCGTCGGATACTCTG -> AAGGCGTCGGATACTCTGG
ATTTATGTAGGCGGTCCCG -> TTTATGTAGGCGGTCCCGG
ATGTCTGGGCTAGTCAATC -> TGTCTGGGCTAGTCAATCT
AGCTTGCCCCGGGACAGCG -> GCTTGCCCCGGGACAGCGC
GCGACCTCGATTAGAGATT -> CGACCTCGATTAGAGATTT
TGTTAGAGCCTACAATCGG -> GTTAGAGCCTACAATCGGC
ATAGAAACTACTCTGATGG -> TAGAAACTACTCTGATGGT
AAGCCGTAGCGTGCAGGCG -> AGCCGTAGCGTGCAGGCGT
CGAACACTTCCTGCGCCTC -> GAACACTTCCTGCGCCTCA
TTACCCTGCGCTGACTTGA -> TACCCTGCGCTGACTTGAG
CGTCCCTTCTGTTAGAGCC -> GTCCCTTCTGTTAGAGCCT
CCCTGCGCTGACTTGAGAA -> CCTGCGCTGACTTGAGAAG
TGTTTACAAGATAAAATTG -> GTTTACAAGATAAAATTGA
TGCTAGGAACCCTCCGAGA -> GCTAGGAACCCTCCGAGAC
CCCGGGACAGCGCGTAATA -> CCGGGACAGCGCGTAATAA
AATTGAAAAGTCGTGGGAG -> ATTGAAAAGTCGTGGGAGT
AATTCTTTCTGCGTCTGTT -> ATTCTTTCTGCGTCTGTTC
TCTGGAACCTCGTACTATT -> CTGGAACCTCGTACTATTT
GGTTGAACCCGGAAAAGCC -> GTTGAACCCGGAAAAGCCG
CCCAATCTGTGTCTACGTC -> CCAATCTGTGTCTACGTCT
TGAAACTACTCTGATGGTT -> GAAACTACTCTGATGGTTT
TACTTTCTCAGCTTGGACA -> ACTTTCTCAGCTTGGACAA
CTCATGATAGCCGCACACC -> TCATGATAGCCGCACACCT
TTTAATTAGACCTGCAATC -> TTAATTAGACCTGCAATCA
ATGAACATTTAAACTTTGC -> TGAACATTTAAACTTTGCA
ACTTCGGGCTAGTTATACC -> CTTCGGGCTAGTTATACCA
ATGGTTGACCGATCGGGTT -> TGGTTGACCGATCGGGTTA
ACGCGGCCAAGATGAACAT -> CGCGGCCAAGATGAACATT
AAATGACTGCGGTACTCTC -> AATGACTGCGGTACTCTCT
GAGGACGCATGCGGATTGT -> AGGACGCATGCGGATTGTG
AATCGGGAAAGAACTAAAG -> ATCGGGAAAGAACTAAAGC
CGGGTACTCAAGTATGACG -> GGGTACTCAAGTATGACGA
GAGGTACTGCTTTCTGCTA -> AGGTACTGCTTTCTGCTAC
ATCTATTGTTCATTTATGT -> TCTATTGTTCATTTATGTA
ATTACAGCATGGCAGAAGC -> TTACAGCATGGCAGAAGCC
AGTGCGTGCCCTTTCGGAA -> GTGCGTGCCCTTTCGGAAA
ATCAGCACCGTCATTTAAA -> TCAGCACCGTCATTTAAAC
TCGCTAACCATTGAAACTC -> CGCTAACCATTGAAACTCG
TTGGGGAACCCACCGACGA -> TGGGGAACCCACCGACGAA
CTTCTGCGGAGCACGGCTT -> TTCTGCGGAGCACGGCTTC
CTTTCTCAGCTTGGACAAA -> TTTCTCAGCTTGGACAAAA
TTGCAATGCTCTAGCATAC -> TGCAATGCTCTAGCATACC
TTGTTTACAAGATAAAATT -> TGTTTACAAGATAAAATTG
AAGTCGGACTCGCTAACCA -> AGTCGGACTCGCTAACCAT
ACTATTTTGTCAATAAACC -> CTATTTTGTCAATAAACCA
GAAAGAACTAAAGCAGGCG -> AAAGAACTAAAGCAGGCGG
CTACGTCTACCATGTTCAT -> TACGTCTACCATGTTCATG
GTGTGACTCCGAAGAAATC -> TGTGACTCCGAAGAAATCT
AAAAGCCGTAGCGTGCAGG -> AAAGCCGTAGCGTGCAGGC
TCAGCCCGTCCCTTCTGTT -> CAGCCCGTCCCTTCTGTTA
TAGCCTTTCAAGGCGTCGG -> AGCCTTTCAAGGCGTCGGA
ACCGCCCTTGTTCCCGACA -> CCGCCCTTGTTCCCGACAA
GCGTACAGAATACCGCGTA -> CGTACAGAATACCGCGTAA
CGTGCGTCCACAGGATGAT -> GTGCGTCCACAGGATGATT
CCGTGTATACTCAAAGTCG -> CGTGTATACTCAAAGTCGG
GGGGAACCCACCGACGAAA -> GGGAACCCACCGACGAAAT
TGATAGACGCCACGACTCC -> GATAGACGCCACGACTCCC
ACCGTGTATACTCAAAGTC -> CCGTGTATACTCAAAGTCG
AATGCTCTAGCATACCTAT -> ATGCTCTAGCATACCTATA
TAGACGCCACGACTCCCCA -> AGACGCCACGACTCCCCAG
TATCGCTCACATGTAAGAG -> ATCGCTCACATGTAAGAGG
CATTTGCGTTAGCATAACC -> ATTTGCGTTAGCATAACCC
CGGAACGGGCGCATTATTG -> GGAACGGGCGCATTATTGC
CCTCGCTCATGTTCGGAAC -> CTCGCTCATGTTCGGAACA
GACGCATGCGGATTGTGAT -> ACGCATGCGGATTGTGATA
GCTCTCGATGGTATTCTGC -> CTCTCGATGGTATTCTGCT
GGGCTAGTCAATCTACTCC -> GGCTAGTCAATCTACTCCT
ACCAACCGTTAAAATCGGG -> CCAACCGTTAAAATCGGGA
CCGTGTATAACAGCTCTCG -> CGTGTATAACAGCTCTCGA
TCATTTAAACACTATTGGA -> CATTTAAACACTATTGGAG
TTAAGAGAAGCGTTAGAGA -> TAAGAGAAGCGTTAGAGAT
GGTCCCGGGTACTCAAGTA -> GTCCCGGGTACTCAAGTAT
ATTCTACTTTCTCAGCTTG -> TTCTACTTTCTCAGCTTGG
ACACGTGTGACCTTACCTC -> CACGTGTGACCTTACCTCG
ATCAATCAATTATTTGTTT -> TCAATCAATTATTTGTTTA
TAAACACTATTGGAGAGCC -> AAACACTATTGGAGAGCCG
TTTAAGAGAAGCGTTAGAG -> TTAAGAGAAGCGTTAGAGA
AAAAGTCGTGGGAGTCAAG -> AAAGTCGTGGGAGTCAAGG
TTCTACTTTCTCAGCTTGG -> TCTACTTTCTCAGCTTGGA
CTGCTCAAATGTTTGTCTT -> TGCTCAAATGTTTGTCTTT
CAGCACCGTCATTTAAACA -> AGCACCGTCATTTAAACAC
ATCAAATTACTTCGGGCTA -> TCAAATTACTTCGGGCTAG
TGGGAGTCAAGGCGCAGCC -> GGGAGTCAAGGCGCAGCCA
TAAGAGAAGCGTTAGAGAT -> AAGAGAAGCGTTAGAGATT
GCCATGTCTGGGCTAGTCA -> CCATGTCTGGGCTAGTCAA
TTTCCGCTATTCACGGCTC -> TTCCGCTATTCACGGCTCG
TCTGTTAAAATGACTGCGG -> CTGTTAAAATGACTGCGGT
ATCAAGGCCTTTAGTCTCA -> TCAAGGCCTTTAGTCTCAC
AACTGCGAGCAAGGTCAGC -> ACTGCGAGCAAGGTCAGCC
GACCCGGCCGAACACTTCC -> ACCCGGCCGAACACTTCCT
CCTTCTGTTAGAGCCTACA -> CTTCTGTTAGAGCCTACAA
GAGCATGCTCCGACCACGC -> AGCATGCTCCGACCACGCG
TTTTAAATAGGGATTTTAT -> TTTAAATAGGGATTTTATG
GCAAGTCCGTCTTCAGGCG -> CAAGTCCGTCTTCAGGCGC
CCCCTGTGACACGCATCGG -> CCCTGTGACACGCATCGGC
CATGAGGTCATGCGAAAGT -> ATGAGGTCATGCGAAAGTA
TAGTCTCACACCTGAGGTC -> AGTCTCACACCTGAGGTCC
GGCAACAATTTATCTACTT -> GCAACAATTTATCTACTTA
CATCAGCACCGTCATTTAA -> ATCAGCACCGTCATTTAAA
GATTTCCGCTATTCGTCAA -> ATTTCCGCTATTCGTCAAA
CTGGGCTAGTCAATCTACT -> TGGGCTAGTCAATCTACTC
GGAAACGCCGACACTACAC -> GAAACGCCGACACTACACA
ACCGCCATGACACAGCCGT -> CCGCCATGACACAGCCGTT
GGGCTAGTTATACCAAGAT -> GGCTAGTTATACCAAGATA
CGCGCGGCTTGGGGAACCC -> GCGCGGCTTGGGGAACCCA
CAATCACGCGGCCAAGATG -> AATCACGCGGCCAAGATGA
GACAAAACCGAGGCTCTCA -> ACAAAACCGAGGCTCTCAG
CATCTGTGTAACGACCAGA -> ATCTGTGTAACGACCAGAT
GACTCCGAAGAAATCTAAC -> ACTCCGAAGAAATCTAACA
TCCGCTATTCGTCAAATGT -> CCGCTATTCGTCAAATGTC
TGATAATCCCAATCTGTGT -> GATAATCCCAATCTGTGTC
CGTATCACCGTGCGTCCAC -> GTATCACCGTGCGTCCACA
ACTTATCCTAATGAGACCC -> CTTATCCTAATGAGACCCG
TATCTACTTATCCTAATGA -> ATCTACTTATCCTAATGAG
CAACAATTTATCTACTTAT -> AACAATTTATCTACTTATC
TCATTTATGTAGGCGGTCC -> CATTTATGTAGGCGGTCCC
GTCTACGTCTACCATGTTC -> TCTACGTCTACCATGTTCA
CCGCTATTCGTCAAATGTC -> CGCTATTCGTCAAATGTCT
GAGGCGGTTGGATAGCGTA -> AGGCGGTTGGATAGCGTAT
CTGAGGTCCTGCTCGTATC -> TGAGGTCCTGCTCGTATCA
AGGCGCAGCCAACTTACTC -> GGCGCAGCCAACTTACTCA
GGTTGGATAGCGTATGTCC -> GTTGGATAGCGTATGTCCA
AAAGTCGTGGGAGTCAAGG -> AAGTCGTGGGAGTCAAGGC
TTCAGGCGCCAATATCCTC -> TCAGGCGCCAATATCCTCG
CTTAATTGCTGGAGAGCCT -> TTAATTGCTGGAGAGCCTC
TGCCCCGGGACAGCGCGTA -> GCCCCGGGACAGCGCGTAA
GCACCGTCATTTAAACACT -> CACCGTCATTTAAACACTA
CCGGACTAGAGGACGCATG -> CGGACTAGAGGACGCATGC
CCGAAGAAATCTAACAGAG -> CGAAGAAATCTAACAGAGC
GAGATTTCCGCTATTCTGG -> AGATTTCCGCTATTCTGGA
CCGACGCCGTCGAAACTAC -> CGACGCCGTCGAAACTACT
GGTCATGCGAAAGTATCGC -> GTCATGCGAAAGTATCGCT
GGAAACTACTCTGATGGTT -> GAAACTACTCTGATGGTTG
ATCGCTCACATGTAAGAGG -> TCGCTCACATGTAAGAGGC
TGCAATCACGCGGCCAAGA -> GCAATCACGCGGCCAAGAT
AGGCTAAGGATTCTTGACC -> GGCTAAGGATTCTTGACCT
GACTATCACCGGTGAGTTT -> ACTATCACCGGTGAGTTTA
ACAAAACCGAGGCTCTCAG -> CAAAACCGAGGCTCTCAGT
TCCTAATGAGACCCGGCCG -> CCTAATGAGACCCGGCCGA
TATGAATTGAAAAGTCGTG -> ATGAATTGAAAAGTCGTGG
TGGTTCGCGACCTCGATTA -> GGTTCGCGACCTCGATTAG
TGTATACTCAAAGTCGGAC -> GTATACTCAAAGTCGGACT
CTGATGGTTGACCGATCGG -> TGATGGTTGACCGATCGGG
TCCCCAACCGTGTATACTC -> CCCCAACCGTGTATACTCA
AGGATTCTTGACCTTTGGC -> GGATTCTTGACCTTTGGCC
CTCCGACCACGCGCGGCTT -> TCCGACCACGCGCGGCTTG
ACGGTAAGCTATTCTACTT -> CGGTAAGCTATTCTACTTT
GGGTGGACTATTGGAATCA -> GGTGGACTATTGGAATCAG
TAGAAACTACTCTGATGGT -> AGAAACTACTCTGATGGTT
TTAAACTTTGCAATTGTTA -> TAAACTTTGCAATTGTTAA
AAGGATTCTTGACCTTTGG -> AGGATTCTTGACCTTTGGC
CAGGGAGAAGGCCCACGAT -> AGGGAGAAGGCCCACGATC
ACCTGATCATTTGCGTTAG -> CCTGATCATTTGCGTTAGC
ATATCAAGGCCTTTAGTCT -> TATCAAGGCCTTTAGTCTC
TAGGAACCCTCCGAGACTA -> AGGAACCCTCCGAGACTAT
ACGCCTATACACGTGTGAC -> CGCCTATACACGTGTGACC
CTATTGGAATCAGAACCGC -> TATTGGAATCAGAACCGCC
TGACTCCGAAGAAATCTAA -> GACTCCGAAGAAATCTAAC
GAGTTTAATTAGACCTGCA -> AGTTTAATTAGACCTGCAA
CGCTAACCATTGAAACTCG -> GCTAACCATTGAAACTCGA
GCTTTCTGCTACGGAACGG -> CTTTCTGCTACGGAACGGG
GCGCGGCTTGGGGAACCCA -> CGCGGCTTGGGGAACCCAC
CCTTTAGCCTTTCAAGGCG -> CTTTAGCCTTTCAAGGCGT
CCTTCTGCGGAGCACGGCT -> CTTCTGCGGAGCACGGCTT
AGCCTCTTACCTGATCTAG -> GCCTCTTACCTGATCTAGC
GTGCGTGCCCTTTCGGAAA -> TGCGTGCCCTTTCGGAAAC
GTACTGCTTTCTGCTACGG -> TACTGCTTTCTGCTACGGA
ACCTGCAATCACGCGGCCA -> CCTGCAATCACGCGGCCAA
GACACAGCCGTTTCGTGTA -> ACACAGCCGTTTCGTGTAC
GGGATTTTATGCCTGTCGT -> GGATTTTATGCCTGTCGTG
ACCATGTTCATGACTTCAC -> CCATGTTCATGACTTCACA
TGAGAAGGCTAAGGATTCT -> GAGAAGGCTAAGGATTCTT
TCCTTTAGCCTTTCAAGGC -> CCTTTAGCCTTTCAAGGCG
GTACTAGGTACTCGCCGTA -> TACTAGGTACTCGCCGTAT
ATTGACCCGACCGACTGGA -> TTGACCCGACCGACTGGAC
CTCATGTTCGGAACAAGCT -> TCATGTTCGGAACAAGCTG
GGAACCCTCCGAGACTATC -> GAACCCTCCGAGACTATCA
TTACCTGATCTAGCCTGAT -> TACCTGATCTAGCCTGATC
CTCACATGTAAGAGGCGGT -> TCACATGTAAGAGGCGGTT
GATATCAAGGCCTTTAGTC -> ATATCAAGGCCTTTAGTCT
AGGCGTACAGAATACCGCG -> GGCGTACAGAATACCGCGT
ACCGGTGAGTTTAATTAGA -> CCGGTGAGTTTAATTAGAC
GACATTATGTCACTGGCAG -> ACATTATGTCACTGGCAGT
GCCTTTAGTCTCACACCTG -> CCTTTAGTCTCACACCTGA
CCGCGTAAAGCTTAATTGC -> CGCGTAAAGCTTAATTGCT
ACCAGTAGAATAGACTTGC -> CCAGTAGAATAGACTTGCT
AAGCTATTCTACTTTCTCA -> AGCTATTCTACTTTCTCAG
GCCAACTTACTCATGTGAC -> CCAACTTACTCATGTGACT
TAGTAAAGAGATCTGGAAC -> AGTAAAGAGATCTGGAACC
TCAGGGAGAAGGCCCACGA -> CAGGGAGAAGGCCCACGAT
GAAGCCATGTCTGGGCTAG -> AAGCCATGTCTGGGCTAGT
TCAATCCGGACTAGAGGAC -> CAATCCGGACTAGAGGACG
GTGCTTAGTAAAGAGATCT -> TGCTTAGTAAAGAGATCTG
AGGGATTTTATGCCTGTCG -> GGGATTTTATGCCTGTCGT
CAAGCGTCCTCAAGTGCCC -> AAGCGTCCTCAAGTGCCCA
GCTTCCGTGAAGCACGAGC -> CTTCCGTGAAGCACGAGCC
CTATTCACGGCTCGGTGAG -> TATTCACGGCTCGGTGAGT
CCTAATGAGACCCGGCCGA -> CTAATGAGACCCGGCCGAA
TCCGAAGAAATCTAACAGA -> CCGAAGAAATCTAACAGAG
GAACATTTAAACTTTGCAA -> AACATTTAAACTTTGCAAT
AATTGCTGGAGAGCCTCTT -> ATTGCTGGAGAGCCTCTTA
TGTTAATGGAAAGTACCCC -> GTTAATGGAAAGTACCCCT
ATGCTAATCAATCAATTAT -> TGCTAATCAATCAATTATT
CTATAGCTGTTACCGTGGA -> TATAGCTGTTACCGTGGAC
AAGTACCCCTGTGACACGC -> AGTACCCCTGTGACACGCA
CGTGTACCGTGAGCTTGTC -> GTGTACCGTGAGCTTGTCA
GTCAATCTACTCCTTCCCC -> TCAATCTACTCCTTCCCCA
TGTCGTGCGTTACCCTGCG -> GTCGTGCGTTACCCTGCGC
ACTCAAGTATGACGAAATG -> CTCAAGTATGACGAAATGC
GCCGACACTACACATGTAG -> CCGACACTACACATGTAGG
GAATCAGAACCGCCTATAG -> AATCAGAACCGCCTATAGC
GTGGGAGTCAAGGCGCAGC -> TGGGAGTCAAGGCGCAGCC
AAACCAACCGTTAAAATCG -> AACCAACCGTTAAAATCGG
GCCGTATCACCGTGCGTCC -> CCGTATCACCGTGCGTCCA
TCTACTCCTTCCCCAACCG -> CTACTCCTTCCCCAACCGT
CTAGTCAATCTACTCCTTC -> TAGTCAATCTACTCCTTCC
CGCCGTCGAAACTACTCTG -> GCCGTCGAAACTACTCTGA
CTACGAACCAGTAGAATAG -> TACGAACCAGTAGAATAGA
CCTGCGCTGACTTGAGAAG -> CTGCGCTGACTTGAGAAGG
AGGCGCCAATATCCTCGAG -> GGCGCCAATATCCTCGAGG
TACCTCGCTCATGTTCGGA -> ACCTCGCTCATGTTCGGAA
TACTCTGATGGTTACCTTC -> ACTCTGATGGTTACCTTCT
ACTGGACCGCCATGACACA -> CTGGACCGCCATGACACAG
TCTGATGGTTCGCGACCTC -> CTGATGGTTCGCGACCTCG
ACTCATGTGACTCTTTGTC -> CTCATGTGACTCTTTGTCC
TACCCCTGTGACACGCATC -> ACCCCTGTGACACGCATCG
GAAAAGTCGTGGGAGTCAA -> AAAAGTCGTGGGAGTCAAG
CCAAGATGAACATTTAAAC -> CAAGATGAACATTTAAACT
TACTGTCTGTTAAAATGAC -> ACTGTCTGTTAAAATGACT
CAAATGTCTAGCTTCGCAT -> AAATGTCTAGCTTCGCATC
CTTCTCGACAGAGATGGTC -> TTCTCGACAGAGATGGTCG
GCGGTCCCGGGTACTCAAG -> CGGTCCCGGGTACTCAAGT
ATTGGAGAGCCGACGCCGT -> TTGGAGAGCCGACGCCGTC
TACTCATGTGACTCTTTGT -> ACTCATGTGACTCTTTGTC
TTACCGTGGACGGAATGCT -> TACCGTGGACGGAATGCTA
CTCGTATCAGTGCGTGCCC -> TCGTATCAGTGCGTGCCCT
CTAACAGAGCATGCTCCGA -> TAACAGAGCATGCTCCGAC
CCTGTGACACGCATCGGCT -> CTGTGACACGCATCGGCTG
ATTATGTCACTGGCAGTAT -> TTATGTCACTGGCAGTATC
CAATTATTTGTTTACAAGA -> AATTATTTGTTTACAAGAT
TATAACAGCTCTCGATGGT -> ATAACAGCTCTCGATGGTA
CGACTCAGGTATCTGCTCA -> GACTCAGGTATCTGCTCAA
GGAAGGCCCTTCCGCGGTT -> GAAGGCCCTTCCGCGGTTG
TCGGGCTAGTTATACCAAG -> CGGGCTAGTTATACCAAGA
ATCTAGCCTGATCAAATTA -> TCTAGCCTGATCAAATTAC
ACGGAACGGGCGCATTATT -> CGGAACGGGCGCATTATTG
ATGTTCATGACTTCACAGA -> TGTTCATGACTTCACAGAG
CTCAGGGAGAAGGCCCACG -> TCAGGGAGAAGGCCCACGA
TTCTCGACAGAGATGGTCG -> TCTCGACAGAGATGGTCGC
TCAAGGCGTCGGATACTCT -> CAAGGCGTCGGATACTCTG
CACTATTGGAGAGCCGACG -> ACTATTGGAGAGCCGACGC
TGCCTGTCGTGCGTTACCC -> GCCTGTCGTGCGTTACCCT
AACACTATTGGAGAGCCGA -> ACACTATTGGAGAGCCGAC
TCGCTCACATGTAAGAGGC -> CGCTCACATGTAAGAGGCG
TCTGGATGTGTCTCGACTC -> CTGGATGTGTCTCGACTCA
AAGGCCCTTCCGCGGTTGA -> AGGCCCTTCCGCGGTTGAA
TTATGCCTGTCGTGCGTTA -> TATGCCTGTCGTGCGTTAC
CTTCCTGCGCCTCATGATA -> TTCCTGCGCCTCATGATAG
TGCTCTAGCATACCTATAA -> GCTCTAGCATACCTATAAC
GCGATGTGCTTAGTAAAGA -> CGATGTGCTTAGTAAAGAG
GACTTCACAGAGTGACATT -> ACTTCACAGAGTGACATTA
ACTCCGAAGAAATCTAACA -> CTCCGAAGAAATCTAACAG
CTATTCTACTTTCTCAGCT -> TATTCTACTTTCTCAGCTT
TAGACTTGCTAGGAACCCT -> AGACTTGCTAGGAACCCTC
ATATCCTCGAGGTACTGCT -> TATCCTCGAGGTACTGCTT
AAGGCGCAGCCAACTTACT -> AGGCGCAGCCAACTTACTC
GATGGTTCGCGACCTCGAT -> ATGGTTCGCGACCTCGATT
CCTACAATCGGCTCACTGA -> CTACAATCGGCTCACTGAC
GAGCAAGGTCAGCCCGTCC -> AGCAAGGTCAGCCCGTCCC
ACGTGTTTAAGCTTGCCCC -> CGTGTTTAAGCTTGCCCCG
